id	name	formula
PPA	Inorganic diphosphatase	2.0 h_e + 2.0 pi_c --> h2o_c + h_c + ppi_c
ACLS	Acetolactate synthase	h_c + 2.0 pyr_c --> alac__S_c + co2_c
PDHam1hi	Pyruvate dehydrogenase (acetyl-transferring)	h_c + pyr_c + thmpp_c --> 2ahethmpp_c + co2_c
ECH	(FeFe)-hydrogenase, ferredoxin dependent, membrane-bound	2.0 fdxr_42_c + 3.0 h_c <=> 2.0 fdxo_42_c + h2_c + h_e
AHEXASE3	Beta-N-acetylhexosaminidase, cytosol	chtbs_c + h2o_c --> 2.0 acgam_c
CLBH	Cellobiose hydrolase	cellb_c + h2o_c --> 2.0 glc__D_c
PPBNGS	Porphobilinogen synthase	2.0 5aop_c --> 2.0 h2o_c + h_c + ppbng_c
HMBS	Hydroxymethylbilane synthase	h2o_c + 4.0 ppbng_c --> hmbil_c + 4.0 nh4_c
ATPS	ATPase	atp_c + h2o_c + h_c --> adp_c + 2.0 h_e + pi_c
GLUS	Glutamate synthase (NADH)	akg_c + gln__L_c + h_c + nadh_c --> 2.0 glu__L_c + nad_c
NADK	NAD kinase	atp_c + nad_c --> adp_c + h_c + nadp_c
GLUSy	Glutamate synthase (NADPH)	akg_c + gln__L_c + h_c + nadph_c --> 2.0 glu__L_c + nadp_c
ADK1	Adenylate kinase	amp_c + atp_c + h_c --> 2.0 adp_c
DPCOAK	Dephospho-CoA kinase	atp_c + dpcoa_c --> adp_c + coa_c + h_c
UREA	Urease	h2o_c + 2.0 h_c + urea_c --> co2_c + 2.0 nh4_c
NMNAT	Nicotinamide-nucleotide adenylyltransferase	atp_c + nmn_c --> nad_c + ppi_c
HAMR	Hydroxylamine reductase	h2o_c + nad_c + nh4_c <=> 2.0 h_c + ham_c + nadh_c
NDPK2	Nucleoside-diphosphate kinase (ATP:UDP)	atp_c + udp_c --> adp_c + utp_c
UMPK	UMP kinase	atp_c + h_c + ump_c --> adp_c + udp_c
FMNAT	FMN adenylyltransferase	atp_c + fmn_c --> fad_c + ppi_c
METAT	Methionine adenosyltransferase	atp_c + h2o_c + met__L_c --> amet_c + h_c + pi_c + ppi_c
NTD7	5'-nucleotidase (AMP)	amp_c + h2o_c --> adn_c + pi_c
BPNT	3',5'-bisphosphate nucleotidase	h2o_c + pap_c --> amp_c + pi_c
ADPT	Adenine phosphoribosyltransferase	ade_c + prpp_c --> amp_c + h_c + ppi_c
AHCi	Adenosylhomocysteinase	ahcys_c + h2o_c --> adn_c + hcys__L_c
PPDK	Pyruvate,phosphate dikinase.	amp_c + 2.0 h_c + pep_c + ppi_c --> atp_c + pi_c + pyr_c
PFL	Pyruvate formate lyase	coa_c + pyr_c --> accoa_c + for_c
ME2	Malic enzyme (NADP)	mal__L_c + nadp_c --> co2_c + nadph_c + pyr_c
ACALD	Acetaldehyde dehydrogenase (acetylating)	accoa_c + h_c + nadh_c --> acald_c + coa_c + nad_c
PTAr	Phosphotransacetylase	accoa_c + pi_c <=> actp_c + coa_c
ACS	Acetyl-CoA synthetase	ac_c + atp_c + coa_c --> accoa_c + amp_c + h_c + ppi_c
ACADCOAT	acetyl adenylate:CoA acetyltransferase	accoa_c + amp_c + h_c --> coa_c + cpd03566_c
GLU5K	Glutamate 5-kinase	atp_c + glu__L_c --> adp_c + glu5p_c
GLUDy	Glutamate dehydrogenase (NADP)	glu__L_c + h2o_c + nadp_c <=> akg_c + h_c + nadph_c + nh4_c
OPAH	5-Oxoproline amidohydrolase (ATP-hydrolysing) (ir)	5oxpro_c + atp_c + 2.0 h2o_c <=> adp_c + glu__L_c + h_c + pi_c
GLNS	Glutamine synthetase	atp_c + glu__L_c + nh4_c --> adp_c + gln__L_c + h_c + pi_c
NADS2	Nicotinate-mononucleotide adenylyltransferase	atp_c + dnad_c + gln__L_c + h2o_c --> amp_c + glu__L_c + 2.0 h_c + nad_c + ppi_c
ALATA_L	L-alanine transaminase	akg_c + ala__L_c <=> glu__L_c + pyr_c
ACGS	N-acetylglutamate synthase	accoa_c + glu__L_c --> acglu_c + coa_c + h_c
ICDHyr	Isocitrate dehydrogenase (NADP)	icit_c + nadp_c --> akg_c + co2_c + nadph_c
OXSCL	oxalosuccinate carboxy-lyase (2-oxoglutarate-forming)	h_c + oxasucc_c --> akg_c + co2_c
GALU	UTP-glucose-1-phosphate uridylyltransferase	g1p_c + utp_c <=> ppi_c + udpg_c
HEX1	Hexokinase (D-glucose:ATP)	atp_c + glc__D_c --> adp_c + g6p_c + h_c
ACKr	Acetate kinase	actp_c + adp_c --> ac_c + atp_c
ACADT	ATP:acetate adenylyltransferase	cpd03566_c + ppi_c --> ac_c + atp_c
NDPK1	Nucleoside-diphosphate kinase (ATP:GDP)	atp_c + gdp_c <=> adp_c + gtp_c
GK1	Guanylate kinase (GMP:ATP)	atp_c + gmp_c + h_c <=> adp_c + gdp_c
PPGPPDP	Guanosine-3',5'-bis(diphosphate) 3'-diphosphatase	h2o_c + ppgpp_c --> gdp_c + h_c + ppi_c
PC	Pyruvate carboxylase	atp_c + co2_c + h2o_c + pyr_c --> adp_c + 2.0 h_c + oaa_c + pi_c
CS	Citrate synthase	accoa_c + h2o_c + oaa_c --> cit_c + coa_c + h_c
ASPTA	Aspartate transaminase	akg_c + asp__L_c <=> glu__L_c + oaa_c
AGT	Alanine glyoxylate aminotransferase	ala__L_c + glx_c <=> gly_c + pyr_c
GLYAT	Glycine C-acetyltransferase	accoa_c + gly_c <=> 2aobut_c + coa_c
GLYTA	Glycine transaminase	akg_c + gly_c <=> glu__L_c + glx_c
ALAR	Alanine racemase	ala__L_c --> ala__D_c
UAG2EMA	UDP-N-acetyl-D-glucosamine 2-epimerase (Hydrolysis)	h2o_c + uacgam_c --> acmana_c + udp_c
UAGP2UAG	UTP:N-acetyl-alpha-D-glucosamine-1-phosphate uridylyltransferase	acgam1p_c + utp_c --> ppi_c + uacgam_c
UAG4Ei	UDP-N-acetylglucosamine 4-epimerase	uacgam_c --> udpacgal_c
UAG2E	UDP-N-acetylglucosamine 2-epimerase	uacgam_c --> uacmam_c
GTPCII2	GTP cyclohydrolase II (25drapp)	gtp_c + 3.0 h2o_c --> 25drapp_c + for_c + 3.0 h_c + ppi_c
NTPP2	Nucleoside triphosphate pyrophosphorylase (gtp)	gtp_c + h2o_c --> gmp_c + 2.0 h_c + ppi_c
NTPH	GTP 7,8-8,9-dihydrolase Folate biosynthesis EC:3.5.4.16	gtp_c + h2o_c --> cpd03518_c
GTPDPK	GTP diphosphokinase	atp_c + gtp_c --> amp_c + gdptp_c + h_c
PEPCK_re	Phosphoenolpyruvate carboxykinase (GTP)	co2_c + gdp_c + pep_c --> gtp_c + oaa_c
DAPDC	Diaminopimelate decarboxylase	26dap__M_c + h_c --> co2_c + lys__L_c
LYSDC	Lysine decarboxylase	h_c + lys__L_c --> 15dap_c + co2_c
HOGL	D-4-Hydroxy-2-oxoglutarate glyoxylate-lyase	4h2oglt_c <=> glx_c + pyr_c
ASPK	Aspartate kinase	asp__L_c + atp_c --> 4pasp_c + adp_c
ASNS2	Asparagine synthetase	asp__L_c + atp_c + nh4_c --> amp_c + asn__L_c + 2.0 h_c + ppi_c
ASP1DC	Aspartate 1-decarboxylase	asp__L_c + h_c --> ala_B_c + co2_c
ADSK	Adenylyl-sulfate kinase	aps_c + atp_c --> adp_c + h_c + paps_c
NTD4	5'-nucleotidase (CMP)	cmp_c + h2o_c --> cytd_c + pi_c
CYTK1	Cytidylate kinase (CMP)	atp_c + cmp_c + h_c <=> adp_c + cdp_c
CYTDK1	ATP:cytidine 5'-phosphotransferase	atp_c + cytd_c --> adp_c + cmp_c + h_c
UTCY	UTP:cytidine 5'-phosphotransferase	cytd_c + utp_c --> cmp_c + h_c + udp_c
CYTDK2	Cytidine kinase (GTP)	cytd_c + gtp_c --> cmp_c + gdp_c + h_c
SADT	Sulfate adenylyltransferase	atp_c + so4_c --> aps_c + ppi_c
RBFK	Riboflavin kinase	atp_c + ribflv_c --> adp_c + fmn_c + h_c
DCTPD2	DCTP deaminase	ctp_c + h2o_c + h_c --> nh4_c + utp_c
NDPK3	Nucleoside-diphosphate kinase (ATP:CDP)	atp_c + cdp_c <=> adp_c + ctp_c
CTPS1	CTP synthase  NH3 	atp_c + nh4_c + utp_c --> adp_c + ctp_c + 2.0 h_c + pi_c
CTPS2	CTP synthase (glutamine)	atp_c + gln__L_c + h2o_c + utp_c --> adp_c + ctp_c + glu__L_c + 2.0 h_c + pi_c
CBPS	Carbamoyl-phosphate synthase (glutamine-hydrolysing)	2.0 atp_c + co2_c + gln__L_c + 2.0 h2o_c --> 2.0 adp_c + cbp_c + glu__L_c + 3.0 h_c + pi_c
ASNS1	Asparagine synthase (glutamine-hydrolysing)	asp__L_c + atp_c + gln__L_c + h2o_c --> amp_c + asn__L_c + glu__L_c + 2.0 h_c + ppi_c
PSP	Phosphoserine phosphatase	h2o_c + pser__L_c --> pi_c + ser__L_c
SPTc	Serine-pyruvate aminotransferase	pyr_c + ser__L_c <=> ala__L_c + hpyr_c
SERAT	Serine O-acetyltransferase	accoa_c + ser__L_c --> acser_c + coa_c
SGAT	Serine--glyoxylate aminotransferase	glx_c + ser__L_c --> gly_c + hpyr_c
TDP	Thiamin pyrophosphatase	h2o_c + thmpp_c --> 2.0 h_c + pi_c + thmmp_c
TMDPPK	Thiamine diphosphate kinase	atp_c + thmpp_c --> adp_c + thmtp_c
TMDPK	Thiamine diphosphokinase	atp_c + thm_c --> amp_c + h_c + thmpp_c
ENO	Enolase	2pg_c <=> h2o_c + pep_c
UAGCVT	UDP-N-acetylglucosamine 1-carboxyvinyltransferase	pep_c + uacgam_c --> pi_c + uaccg_c
NTTP8	Uridine triphosphate pyrophosphohydrolase Pyrimidine metabolism EC:3.6.1.19	h2o_c + utp_c --> 2.0 h_c + ppi_c + ump_c
TRPS2	Tryptophan synthase (indole)	indole_c + ser__L_c --> h2o_c + trp__L_c
AROH	L-Arogenate hydro-lyase	Largn_c + h_c --> co2_c + h2o_c + phe__L_c
PHETA1	Phenylalanine transaminase	akg_c + phe__L_c <=> glu__L_c + phpyr_c
LDH_L	L-lactate dehydrogenase	h_c + nadh_c + pyr_c --> lac__L_c + nad_c
ALDD2x	Aldehyde dehydrogenase (acetaldehyde, NAD)	acald_c + h2o_c + nad_c --> ac_c + 2.0 h_c + nadh_c
ALDD2y	Aldehyde dehydrogenase (acetaldehyde, NADP)	acald_c + h2o_c + nadp_c --> ac_c + 2.0 h_c + nadph_c
GLYCLTDx	Glycolate dehydrogenase (NAD)	glyclt_c + nad_c <=> glx_c + h_c + nadh_c
NTPP9	Nucleoside triphosphate pyrophosphorylase (itp)	h2o_c + itp_c --> 2.0 h_c + imp_c + ppi_c
NDPK9	ATP:IDP phosphotransferase, mitochondria	atp_c + idp_c --> adp_c + itp_c
TYRTA	Tyrosine transaminase	akg_c + tyr__L_c <=> 34hpp_c + glu__L_c
ACCOAC	Acetyl-CoA carboxylase	accoa_c + atp_c + co2_c + h2o_c --> adp_c + 2.0 h_c + malcoa_c + pi_c
ALCD2x	Alcohol dehydrogenase (ethanol)	acald_c + h_c + nadh_c --> etoh_c + nad_c
G6PDA_1	D-glucosamine-6-phosphate aminohydrolase (ketol isomerizing)	gam6p_c + h2o_c --> f6p_B_c + nh4_c
GF6PTA	Glutamine-fructose-6-phosphate transaminase	f6p_B_c + gln__L_c --> gam6p_c + glu__L_c
CYSDS	Cysteine Desulfhydrase	cys__L_c + h2o_c --> h2s_c + h_c + nh4_c + pyr_c
G3PD1ir	Glycerol 3 phosphate dehydrogenase  NAD 	dhap_c + h_c + nadh_c --> glyc3p_c + nad_c
G3PD2	Glycerol-3-phosphate dehydrogenase (NADP)	dhap_c + h_c + nadph_c --> glyc3p_c + nadp_c
GLYK	Glycerol kinase	atp_c + glyc_c --> adp_c + glyc3p_c + h_c
HSOR	hydrogen-sulfide:NADP+ oxidoreductase	3.0 h_c + 3.0 nadph_c + so3_c --> 3.0 h2o_c + h2s_c + 3.0 nadp_c
SULR_ferr	Sulfite reductase (ferredoxin)	6.0 fdxr_42_c + 6.0 h_c + so3_c --> 6.0 fdxo_42_c + 3.0 h2o_c + h2s_c
HEX7	Hexokinase (D-fructose:ATP)	atp_c + fru_c --> adp_c + f6p_B_c + h_c
SBTD_D2	D sorbitol dehydrogenase  D fructose producing 	nad_c + sbt__D_c --> fru_c + h_c + nadh_c
MAN1PT	Mannose 1 phosphate guanylyltransferase	gtp_c + man1p_c --> gdpmann_c + ppi_c
CYSTA	Cysteine transaminase	glu__L_c + mercppyr_c --> akg_c + cys__L_c
CYSS	Cysteine synthase	acser_c + h2s_c --> ac_c + cys__L_c
AMPTASECG	Alanyl aminopeptidase (cys-gly)	cgly_c + h2o_c <=> cys__L_c + gly_c
ALDD22x	Aldehyde dehydrogenase  3 aminopropanal  NAD 	aproa_c + h2o_c + nad_c --> ala_B_c + 2.0 h_c + nadh_c
PCMT	propanoyl-CoA:(2S)-methylmalonyl-CoA malonyltransferase (cyclizing);	12.0 h_c + 6.0 mmcoa__S_c + 6.0 nadph_c + ppcoa_c --> 6doer_c + 6.0 co2_c + 7.0 coa_c + h2o_c + 6.0 nadp_c
PTA2	Phosphate acetyltransferase	pi_c + ppcoa_c --> coa_c + ppap_c
PACPT	Propionyladenylate:CoA propionyltransferase	coa_c + cpd03560_c <=> amp_c + h_c + ppcoa_c
MCITS	2-methylcitrate synthase	h2o_c + oaa_c + ppcoa_c --> 2mcit_c + coa_c + h_c
DHFR2i	Dihydrofolate reductase (NAD+)	dhf_c + h_c + nadh_c --> nad_c + thf_c
THFOR1	5,6,7,8-Tetrahydrofolate:NAD+ oxidoreductase	fol_c + 2.0 h_c + 2.0 nadh_c --> 2.0 nad_c + thf_c
DHFR	Dihydrofolate reductase	dhf_c + h_c + nadph_c --> nadp_c + thf_c
THFOR2	5,6,7,8-Tetrahydrofolate:NADP+ oxidoreductase	fol_c + 2.0 h_c + 2.0 nadph_c --> 2.0 nadp_c + thf_c
THFGLUS	Tetrahydrofolate:L-glutamate gamma-ligase (ADP-forming)	atp_c + glu__L_c + thf_c --> adp_c + h_c + pi_c + thfyglu_c
FTHFLi	Formate-tetrahydrofolate ligase	atp_c + for_c + thf_c --> 10fthf_c + adp_c + pi_c
GHMT2r	Glycine hydroxymethyltransferase, reversible	gly_c + h2o_c + mlthf_c <=> ser__L_c + thf_c
METS	Methionine synthase	5mthf_c + hcys__L_c --> met__L_c + thf_c
GLGC	Glucose-1-phosphate adenylyltransferase	atp_c + g1p_c --> adpglc_c + ppi_c
CEPA	Cellobiose phosphorylase	cellb_c + pi_c --> g1p_c + glc__D_c
G1PCTYT	Alpha-D-glucose cytidylyltransferase	ctp_c + g1p_c --> cdpglc_c + ppi_c
ITCY	ITP:cytidine 5'-phosphotransferase	cytd_c + itp_c --> cmp_c + h_c + idp_c
NTD2	5'-nucleotidase (UMP)	h2o_c + ump_c --> pi_c + uri_c
URIK1	Uridine kinase  ATPUridine 	atp_c + uri_c --> adp_c + h_c + ump_c
UPPRT	Uracil phosphoribosyltransferase	prpp_c + ura_c --> h_c + ppi_c + ump_c
UTUP	UTP:uridine 5'-phosphotransferase	uri_c + utp_c --> h_c + udp_c + ump_c
URIK2	Uridine kinase (GTP:Uridine)	gtp_c + uri_c --> gdp_c + h_c + ump_c
URIK3	Uridine kinase (ITP:Uridine)	itp_c + uri_c --> h_c + idp_c + ump_c
ANS	Anthranilate synthase	chor_c + gln__L_c --> anth_c + glu__L_c + h_c + pyr_c
MMOR	Methylmalate oxidoreductase(NAD)	nad_c + r3mmal_c --> 2obut_c + co2_c + nadh_c
SHSL4	O-Succinyl-L-homoserine succinate-lyase (deaminating;2-oxobutanoate-forming)	h2o_c + suchms_c --> 2obut_c + h_c + nh4_c + succ_c
2HBO	2 HydroxybutyrateNAD oxidoreductase	2hb_c + nad_c --> 2obut_c + h_c + nadh_c
CYSTGL	Cystathionine g lyase	cyst_L_c + h2o_c --> 2obut_c + cys__L_c + nh4_c
DOLPMT	Dolichyl-phosphate beta-D-mannosyltransferase	dolp_c + gdpmann_c + h_c --> dolmanp_c + gdp_c
TPI	Triose-phosphate isomerase	g3p_c <=> dhap_c
MGSA	Methylglyoxal synthase	dhap_c --> mthgxl_c + pi_c
PRPPS	Phosphoribosylpyrophosphate synthetase	atp_c + r5p_c --> amp_c + h_c + prpp_c
ADPRDP	ADPribose diphosphatase	adprib_c + h2o_c --> amp_c + 2.0 h_c + r5p_c
RPI	Ribose-5-phosphate isomerase	r5p_c <=> ru5p__D_c
PPM	Phosphopentomutase	r1p_c <=> r5p_c
GAPD	Glyceraldehyde-3-phosphate dehydrogenase	g3p_c + nad_c + pi_c <=> 13dpg_c + h_c + nadh_c
DRPA	Deoxyribose-phosphate aldolase	2dr5p_c --> acald_c + g3p_c
TGBPA	Tagatose-bisphosphate aldolase	tagdp__D_c --> dhap_c + g3p_c
ATPPRT	ATP phosphoribosyltransferase	atp_c + prpp_c --> h_c + ppi_c + prbatp_c
GLUPRT	Glutamine phosphoribosyldiphosphate amidotransferase	gln__L_c + h2o_c + prpp_c --> glu__L_c + h_c + ppi_c + pram_c
ANPRT	Anthranilate phosphoribosyltransferase	anth_c + prpp_c --> h_c + ppi_c + pran_c
BACCL	Biotin acetyl CoA carboxylase ligase	atp_c + btn_c --> btamp_c + ppi_c
FUM	Fumarase	mal__L_c <=> fum_c + h2o_c
ADSL1r	Adenylsuccinate lyase	dcamp_c <=> amp_c + fum_c
ARGSL	Argininosuccinate lyase	argsuc_c <=> arg__L_c + fum_c
LEUTA	Leucine transaminase	4mop_c + glu__L_c --> akg_c + leu__L_c
ACNMCT	CTP:N-acylneuraminate cytidylyltransferase	acnam_c + ctp_c --> cmpacna_c + h_c + ppi_c
IPDPTA	delta2-isopentenyl-diphosphate:tRNA isopentenyltransferase	dmpp_c + trna_c <=> 6ipadtrna_c + ppi_c
NTD11	5'-nucleotidase (IMP)	h2o_c + imp_c --> ins_c + pi_c
IMPC	IMP cyclohydrolase	h2o_c + imp_c <=> fprica_c
IMPD	IMP dehydrogenase	h2o_c + imp_c + nad_c <=> h_c + nadh_c + xmp_c
ADSS	Adenylosuccinate synthase	asp__L_c + gtp_c + imp_c --> dcamp_c + gdp_c + 2.0 h_c + pi_c
NDPK8	Nucleoside-diphosphate kinase	atp_c + dadp_c --> adp_c + datp_c
ALAALAr	D-alanine-D-alanine ligase (reversible)	2.0 ala__D_c + atp_c --> adp_c + diala__L_c + h_c + pi_c
AGMT	Agmatinase	agm_c + h2o_c --> ptrc_c + urea_c
LHOR	L-histidinal:NAD+ oxidoreductase	cpd01324_c + h2o_c + nad_c --> 2.0 h_c + his__L_c + nadh_c
NHHA	Nalpha-(beta-alanyl)-L-histidine hydrolase	carn_c + h2o_c <=> ala_B_c + his__L_c
BTCOARx	Butanal:NAD+ oxidoreductase (CoA-acylating)	btcoa_c + h_c + nadh_c --> btal_c + coa_c + nad_c
POR	Pyruvate-ferredoxin oxidoreductase	coa_c + 2.0 fdxo_42_c + pyr_c --> accoa_c + co2_c + 2.0 fdxr_42_c + h_c
OOR3	2-oxoglutarate:ferredoxin oxidoreductase (decarboxylating)	akg_c + coa_c + 2.0 fdxo_42_c --> co2_c + 2.0 fdxr_42_c + h_c + succoa_c
OBFOR	2-oxobutanoate:ferredoxin 2-oxidoreductase (CoA-propanoylating)	2obut_c + coa_c + 2.0 fdxo_42_c --> co2_c + 2.0 fdxr_42_c + h_c + ppcoa_c
DHAD1	Dihydroxy-acid dehydratase (2,3-dihydroxy-3-methylbutanoate)	23dhmb_c --> 3mob_c + h2o_c
IPPS	2-isopropylmalate synthase	3mob_c + accoa_c + h2o_c --> 3c3hmp_c + coa_c + h_c
VALTA	Valine transaminase	akg_c + val__L_c <=> 3mob_c + glu__L_c
MTHFD	Methylenetetrahydrofolate dehydrogenase (NADP)	mlthf_c + nadp_c <=> methf_c + nadph_c
MTHFO_nadp	5-methyltetrahydrofolate:NADP+ oxidoreductase	h_c + mlthf_c + nadph_c --> 5mthf_c + nadp_c
MOHMT	3-methyl-2-oxobutanoate hydroxymethyltransferase	3mob_c + h2o_c + mlthf_c --> 2dhp_c + thf_c
NTD9	5'-nucleotidase (GMP)	gmp_c + h2o_c --> gsn_c + pi_c
GPAR	GMP:diphosphate 5-phospho-alpha-D-ribosyltransferase	gua_c + prpp_c --> gmp_c + h_c + ppi_c
GMPS	GMP synthase	atp_c + nh4_c + xmp_c --> amp_c + gmp_c + 3.0 h_c + ppi_c
GMPS2	GMP synthase	atp_c + gln__L_c + h2o_c + xmp_c --> amp_c + glu__L_c + gmp_c + 3.0 h_c + ppi_c
PRO1x	Proline oxidase  NAD  	1pyr5c_c + 2.0 h_c + nadh_c --> nad_c + pro__L_c
P5CR	Pyrroline-5-carboxylate reductase	1pyr5c_c + 2.0 h_c + nadph_c --> nadp_c + pro__L_c
FACOAL160	Fatty acid  CoA ligase  hexadecanoate  	atp_c + coa_c + hdca_c --> amp_c + h_c + pmtcoa_c + ppi_c
CYSTL	Cystathionine b-lyase	cyst_L_c + h2o_c --> hcys__L_c + nh4_c + pyr_c
AHHST	O-acetyl-L-homoserine:hydrogen sulfide S-(3-amino-3-carboxypropyl)transferase	achms_c + h2s_c --> ac_c + hcys__L_c
SHSL2	O-succinyl-L-homoserine succinate-lyase (adding hydrogen sulfide)	h2s_c + suchms_c --> hcys__L_c + succ_c
ACONT	Aconitate hydratase	cit_c <=> icit_c
PPNDH	Prephenate dehydratase	h_c + pphn_c --> co2_c + h2o_c + phpyr_c
UGE2	UDP-glucuronate 5-epimerase	udpglcur_c <=> cpd01556_c
HPYRRx	Hydroxypyruvate reductase (NADH)	glyc__R_c + nad_c <=> h_c + hpyr_c + nadh_c
ASPCT	Aspartate carbamoyltransferase	asp__L_c + cbp_c --> cbasp_c + h_c + pi_c
OCBT	Ornithine carbamoyltransferase	cbp_c + orn__L_c <=> citr__L_c + h_c + pi_c
MTAP	5  methylthioadenosine phosphorylase	5mta_c + pi_c <=> 5mdr1p_c + ade_c
NBAH	N-Benzoylglycine amidohydrolase	bz_c + gly_c --> bgly_c + h2o_c
THRS	Threonine synthase	h2o_c + phom_c --> pi_c + thr__L_c
PGK	Phosphoglycerate kinase	13dpg_c + adp_c --> 3pg_c + atp_c
PGLYDH	Phosphoglycerate dehydrogenase	3pg_c + nad_c --> 3php_c + h_c + nadh_c
GLYPT	ATP:(R)-glycerate 3-phosphotransferase	atp_c + glyc__R_c --> 3pg_c + adp_c + h_c
PGM	Phosphoglycerate mutase	2pg_c <=> 3pg_c
RPE	Ribulose 5-phosphate 3-epimerase	ru5p__D_c <=> xu5p__D_c
2D3DGLNR	2-Dehydro-3-deoxy-D-gluconate:NAD+ 5-oxidoreductase	2ddglcn_c + nad_c <=> 46dh25dohxn_c + h_c + nadh_c
DADK	Deoxyadenylate kinase	atp_c + damp_c + h_c --> adp_c + dadp_c
DATCY	DATP:cytidine 5'-phosphotransferase	cytd_c + datp_c --> cmp_c + dadp_c + h_c
DATUP	DATP:uridine 5'-phosphotransferase	datp_c + uri_c --> dadp_c + h_c + ump_c
PUNP1	Purine-nucleoside phosphorylase (Adenosine)	adn_c + pi_c <=> ade_c + r1p_c
NTD5	5'-nucleotidase (dTMP)	dtmp_c + h2o_c --> pi_c + thymd_c
ABGPT	ATP:beta-D-glucose 6-phosphotransferase	glc__D_c + gtp_c --> g6p_c + gdp_c + h_c
ACOATA	Acetyl-CoA ACP transacylase	ACP_c + accoa_c --> acACP_c + coa_c
ACPS1	Acyl-carrier protein synthase	apoACP_c + coa_c --> ACP_c + h_c + pap_c
MCOATA	Malonyl-CoA-ACP transacylase	ACP_c + malcoa_c --> coa_c + malACP_c
XYLK	Xylulokinase	atp_c + xylu__D_c <=> adp_c + h_c + xu5p__D_c
MTHFC	Methenyltetrahydrofolate cyclohydrolase	h2o_c + methf_c <=> 10fthf_c + h_c
DMATT	Dimethylallyltranstransferase	dmpp_c + ipdp_c --> ggdp_c + h_c + ppi_c
DCMPDA	DCMP deaminase	dcmp_c + h2o_c + h_c <=> dump_c + nh4_c
NTD3pp	5'-nucleotidase (dCMP)	dcmp_c + h2o_c --> dcyt_c + pi_c
CYTK2n	Cytidylate kinase (dCMP),nuclear	atp_c + dcmp_c + h_c --> adp_c + dcdp_c
CHRS	Chorismate synthase	3psme_c --> chor_c + pi_c
CHORM	Chorismate mutase	chor_c --> pphn_c
ADCS	4-amino-4-deoxychorismate synthase	chor_c + gln__L_c --> 4adcho_c + glu__L_c
NAMNPP	Nicotinic acid mononucleotide pyrophosphorylase	atp_c + h2o_c + nac_c + prpp_c --> adp_c + h_c + nicrnt_c + pi_c + ppi_c
PPND	Prephenate dehydrogenase	nad_c + pphn_c --> 34hpp_c + co2_c + nadh_c
GLYALDDr	D-Glyceraldehyde dehydrogenase	glyald_c + h2o_c + nad_c <=> glyc__R_c + 2.0 h_c + nadh_c
HSDxi	Homoserine dehydrogenase  NADH   irreversible	aspsa_c + h_c + nadh_c --> hom__L_c + nad_c
HSDH	Homoserine dehydrogenase	aspsa_c + h_c + nadph_c --> hom__L_c + nadp_c
HSST	Homoserine O-succinyltransferase	hom__L_c + succoa_c --> coa_c + suchms_c
CDGPT	CDP-diacylglycerol:sn-glycerol-3-phosphate 3-phosphatidyltransferase	cdpdag_BS_c + glyc3p_c --> cmp_c + pgp_EC_c
ACNPLYS	N-Acetylneuraminate pyruvate-lyase	acmana_c + h2o_c + pep_c --> acnam_c + pi_c
PMANM	Phosphomannomutase	man6p_c <=> man1p_c
MPAKI	D-mannose-6-phosphate aldose-ketose-isomerase	man6p_c <=> f6p_B_c
DPHS	3-deoxy-7-phosphoheptulonate synthase	e4p_c + h2o_c + pep_c --> 2dda7p_c + pi_c
NTPP1	Nucleoside triphosphate pyrophosphorylase (dgtp)	dgtp_c + h2o_c --> dgmp_c + 2.0 h_c + ppi_c
NTPTP1	Nucleoside triphosphate tripolyhydrolase	dgtp_c + h2o_c --> dgsn_c + pppi_c
NDPK5	Nucleoside-diphosphate kinase (ATP:dGDP)	atp_c + dgdp_c --> adp_c + dgtp_c
PPCOAC	Propionyl-CoA carboxylase	atp_c + co2_c + h2o_c + ppcoa_c --> adp_c + 2.0 h_c + mmcoa__S_c + pi_c
PUNP5	Purine-nucleoside phosphorylase (Inosine)	ins_c + pi_c <=> hxan_c + r1p_c
DHORD_NAD	Dihydoorotic acid dehydrogenase	dhor__S_c + nad_c --> h_c + nadh_c + orot_c
QUINDH	Quinate dehydrogenase	3dhq_c + h_c + nadh_c --> nad_c + quin_kt_c
CYTD	Cytidine deaminase	cytd_c + h2o_c + h_c --> nh4_c + uri_c
DGTUP	DGTP:uridine 5'-phosphotransferase	dgtp_c + uri_c --> dgdp_c + h_c + ump_c
XYLTD_D	Xylitol dehydrogenase  D xyulose forming 	h_c + nadh_c + xylu__D_c --> nad_c + xylt_c
SPMS	Spermidine synthase	ametam_c + ptrc_c --> 5mta_c + h_c + spmd_c
SALCCM	S-Adenosyl-L-methionine:caffeoyl-CoA 3-O-methyltransferase	amet_c + caffcoa_c <=> ahcys_c + ferulcoa_c + h_c
ARGSS	Argininosuccinate synthase	asp__L_c + atp_c + citr__L_c <=> amp_c + argsuc_c + 2.0 h_c + ppi_c
NTD8	5'-nucleotidase (dGMP)	dgmp_c + h2o_c --> dgsn_c + pi_c
PUNP4	Purine-nucleoside phosphorylase (Deoxyguanosine)	dgsn_c + pi_c <=> 2dr1p_c + gua_c
HBCO	(R)-3-Hydroxybutanoyl-CoA:NADP+ oxidoreductase	3hc4coa_c + nadp_c <=> aacoa_c + 2.0 h_c + nadph_c
AABHH	Alpha-Aminobutyryl histidine hydrolase	4abut_c + his__L_c --> h2o_c + hcarn_c
DHR	Dihydroorotase	dhor__S_c + h2o_c <=> cbasp_c + h_c
RDXR	Rubredoxin oxidoreductase	h_c + nad_c + 2.0 rdxr_c <=> nadh_c + 2.0 rdxo_c
RNTR1	Ribonucleoside triphosphate reductase  ATP 	atp_c + trdrd_c --> datp_c + h2o_c + trdox_c
TRDR	Thioredoxin reductase (NADPH)	h_c + nadph_c + trdox_c --> nadp_c + trdrd_c
RNDR1n	Ribonucleoside diphosphate reductase  nuclear	adp_c + trdrd_c --> dadp_c + h2o_c + trdox_c
RNDR4n	Ribonucleoside diphosphate reductase  UDP   nuclear	trdrd_c + udp_c --> dudp_c + h2o_c + trdox_c
RNDR2	Ribonucleoside-diphosphate reductase (GDP)	gdp_c + trdrd_c --> dgdp_c + h2o_c + trdox_c
RNTR2	Ribonucleoside triphosphate reductase  GTP 	gtp_c + trdrd_c --> dgtp_c + h2o_c + trdox_c
PAPSR	Phosphoadenylyl-sulfate reductase (thioredoxin)	paps_c + trdrd_c --> h_c + pap_c + so3_c + trdox_c
RNTR3	Ribonucleoside triphosphate reductase  CTP 	ctp_c + trdrd_c --> dctp_c + h2o_c + trdox_c
RNTR4	Ribonucleoside triphosphate reductase  UTP 	trdrd_c + utp_c --> dutp_c + h2o_c + trdox_c
RNDR3	Ribonucleoside-diphosphate reductase (CDP)	cdp_c + trdrd_c --> dcdp_c + h2o_c + trdox_c
CLS2	CDP-diacylglycerol:phosphatidylglycerol 3-phosphatidyltransferase	cdpdag_BS_c + pg_SC_c --> clpn_SC_c + cmp_c + h_c
AGDC	N-acetylglucosamine-6-phosphate deacetylase	acgam6p_c + h2o_c --> ac_c + gam6p_c
PGAMT	Phosphoglucosamine mutase	gam1p_c <=> gam6p_c
FRTT	Farnesyltranstransferase	frdp_c + ipdp_c <=> ggdp_c + h_c + ppi_c
F6PPT	PPi:D-fructose-6-phosphate 6-phosphotransferase	f6p_B_c + ppi_c --> fdp_c + h_c + pi_c
NTD6	5'-nucleotidase (dAMP)	damp_c + h2o_c --> dad_2_c + pi_c
DGTCY	DGTP:cytidine 5'-phosphotransferase	cytd_c + dgtp_c --> cmp_c + dgdp_c + h_c
NDPK4	Nucleoside-diphosphate kinase (ATP:dTDP)	atp_c + dtdp_c --> adp_c + dttp_c
DTTGY	DTTP:cytidine 5'-phosphotransferase	cytd_c + dttp_c --> cmp_c + dtdp_c + h_c
DTTUP	DTTP:uridine 5'-phosphotransferase	dttp_c + uri_c --> dtdp_c + h_c + ump_c
DUTPDP	DUTP diphosphatase	dutp_c + h2o_c --> dump_c + 2.0 h_c + ppi_c
TMDS	Thymidylate synthase	dump_c + mlthf_c --> dhf_c + dtmp_c
PUNP3	Purine-nucleoside phosphorylase (Guanosine)	gsn_c + pi_c <=> gua_c + r1p_c
ILETA	Isoleucine transaminase	akg_c + ile__L_c <=> 3mop_c + glu__L_c
DHFOR	Dihydrofolate:NAD+ oxidoreductase	dhf_c + nad_c --> fol_c + h_c + nadh_c
DHFOR2	Dihydrofolate:NADP+ oxidoreductase One carbon pool by folate / Folate biosynthesis EC:1.5.1.3	dhf_c + nadp_c --> fol_c + h_c + nadph_c
DHFS	Dihydrofolate synthase	atp_c + dhpt_c + glu__L_c --> adp_c + dhf_c + h_c + pi_c
PPROR	phenylpropanoate:NAD+ delta2-oxidoreductase	cinnm_c + h_c + nadh_c <=> nad_c + pppn_c
FCLPA	L-fuculose 1-phosphate aldolase	fc1p_c --> dhap_c + lald__L_c
G1SAT	Glutamate-1-semialdehyde aminotransferase	5aop_c <=> glu1sa_c
ORNTAC	Ornithine transacetylase	acorn_c + glu__L_c <=> acglu_c + orn__L_c
ACOTA	Acetylornithine transaminase	acorn_c + akg_c <=> acg5sa_c + glu__L_c
ASAD	Aspartate-semialdehyde dehydrogenase	aspsa_c + nadp_c + pi_c <=> 4pasp_c + h_c + nadph_c
ASAHL	L-Aspartate-4-semialdehyde hydro-lyase (adding pyruvate and cyclizing)	aspsa_c + pyr_c --> 23dhdp_c + 2.0 h2o_c + h_c
PNP	Purine nucleoside phosphorylase	pi_c + rnam_c <=> h_c + ncam_c + r1p_c
NP1	Nucleotide phosphatase	nicrns_c + pi_c <=> h_c + nac_c + r1p_c
PYNP1	Pyrimidine-nucleoside phosphorylase (cytosine)	cytd_c + pi_c <=> csn_c + r1p_c
PUNP7	Purine-nucleoside phosphorylase (Xanthosine)	pi_c + xtsn_c <=> r1p_c + xan_c
FTCL	5-Formyltetrahydrofolate cyclo-ligase (ADP-forming)	5fthf_c + atp_c --> adp_c + methf_c + pi_c
NMNR	Nmn hydrolysis	h2o_c + nmn_c --> pi_c + rnam_c
RNMK	Ribosylnicotinamide kinase	atp_c + rnam_c --> adp_c + h_c + nmn_c
DCTPD	DCTP deaminase	dctp_c + h2o_c + h_c <=> dutp_c + nh4_c
NDPK7	ATP:dCDP phosphotransferase	atp_c + dcdp_c --> adp_c + dctp_c
DCTUP	DCTP:uridine 5'-phosphotransferase	dctp_c + uri_c --> dcdp_c + h_c + ump_c
NDPK6	Nucleoside-diphosphate kinase (ATP:dUDP)	atp_c + dudp_c --> adp_c + dutp_c
DUTUP	DUTP:uridine 5'-phosphotransferase	dutp_c + uri_c --> dudp_c + h_c + ump_c
TRPS3	Tryptophan synthase (indoleglycerol phosphate)	3ig3p_c --> g3p_c + indole_c
DCTCP	DCTP:cytidine 5'-phosphotransferase	cytd_c + dctp_c --> cmp_c + dcdp_c + h_c
DUTCP	DUTP:cytidine 5'-phosphotransferase	cytd_c + dutp_c --> cmp_c + dudp_c + h_c
CTINBL	Cystathionine beta-lyase, cystine	Lcystin_c + h2o_c --> nh4_c + pyr_c + thcys_c
SKDH	Shikimate dehydrogenase	3dhsk_c + h_c + nadph_c --> nadp_c + skm_c
CDPGLC46DH	CDP glucose 4 6 dehydratase	cdpglc_c --> cdp4dh6doglc_c + h2o_c
AATC	Aspartate aminotransferase, cysteate forming	Lcyst_c + akg_c <=> 3spyr_c + glu__L_c
PANTS	Pantothenate synthase	ala_B_c + atp_c + pant__R_c --> amp_c + 2.0 h_c + pnto__R_c + ppi_c
DURIPP	Deoxyuridine phosphorylase	duri_c + pi_c <=> 2dr1p_c + ura_c
DCYTD	Deoxycytidine deaminase	dcyt_c + h2o_c + h_c --> duri_c + nh4_c
PACCOAL	Phenylacetate-CoA ligase	atp_c + coa_c + pac_c --> amp_c + 2.0 h_c + phaccoa_c + ppi_c
PUNP2	Purine-nucleoside phosphorylase (Deoxyadenosine)	dad_2_c + pi_c <=> 2dr1p_c + ade_c
3SALATA	3-sulfino-alanine transaminaseÃ¯Â¿Â½	3sala_c + akg_c <=> 3snpyr_c + glu__L_c
ACGK	Acetylglutamate kinase	acglu_c + atp_c --> acg5p_c + adp_c
ALDD20x	Aldehyde dehydrogenase  indole 3 acetaldehyde  NAD 	h2o_c + id3acald_c + nad_c <=> 2.0 h_c + ind3ac_c + nadh_c
UDPG2DGT	UDPglucose:1,2-diacylglycerol 3-D-glucosyltransferase	dag_gen_c + udpg_c --> 3g12dgr_SA2_c + udp_c
NTD10	5'-nucleotidase (XMP)	h2o_c + xmp_c --> pi_c + xtsn_c
NTPP11	Nucleoside triphosphate pyrophosphorylase (xtp)	h2o_c + xtp_c --> 2.0 h_c + ppi_c + xmp_c
SERH	L-serine hydrolyase	3ig3p_c + ser__L_c --> g3p_c + h2o_c + trp__L_c
DAPE	Diaminopimelate epimerase	26dap_LL_c <=> 26dap__M_c
PUNP6	Purine-nucleoside phosphorylase (Deoxyinosine)	din_c + pi_c <=> 2dr1p_c + hxan_c
PPM2	Phosphopentomutase 2 (deoxyribose)	2dr1p_c <=> 2dr5p_c
DHDOR	meso-2,6-diaminoheptanedioate:NADP+ oxidoreductase (deaminating)	cpd02414_c + h_c + nadph_c + nh4_c --> 26dap__M_c + h2o_c + nadp_c
UAMAGS	UDP-N-acetylmuramoyl-L-alanyl-D-glutamate synthetase	atp_c + glu__D_c + uama_c --> adp_c + h_c + pi_c + uamag_c
UAAGDS	UDP-N-acetylmuramoyl-L-alanyl-D-glutamate:(L)-meso-2,6-diaminoheptanedioate gamma-ligase (ADP-forming);	26dap__M_c + atp_c + uamag_c --> adp_c + h_c + pi_c + ugmd_c
SHCHF	Sirohydrochlorin ferrochelatase	2.0 h_c + sheme_c <=> fe2_c + srch_c
SPRMS	Spermine synthase	ametam_c + spmd_c <=> 5mta_c + h_c + sprm_c
TYRTRS	Tyrosyl-tRNA synthetase	atp_c + trnatyr_c + tyr__L_c --> amp_c + h_c + ppi_c + tyrtrna_c
BDOR	(R,R)-Butane-2,3-diol:NAD+ oxidoreductase	cpd00361_c + h_c + nadh_c --> btd_RR_c + nad_c
ACLDC	Acetolactate decarboxylase	alac__S_c + h_c --> co2_c + cpd00361_c
APNPT	ATP:pantetheine 4'-phosphotransferase	atp_c + ptth_c --> adp_c + h_c + pan4p_c
NNAT	Nicotinate nucleotide adenylyltransferase 	atp_c + nicrnt_c --> dnad_c + ppi_c
HISOR	L-Histidinol:NAD+ oxidoreductase	histd_c + nad_c --> cpd01324_c + h_c + nadh_c
HISTP	Histidinol-phosphatase	h2o_c + hisp_c --> histd_c + pi_c
PNTK	Pantothenate kinase	atp_c + pnto__R_c --> 4ppan_c + adp_c + h_c
ECOAH1	3-hydroxyacyl-CoA dehydratase (3-hydroxybutanoyl-CoA)	b2coa_c + h2o_c + h_c <=> 3hc4coa_c
APPAT	ATP:pantetheine-4'-phosphate adenylyltransferase	atp_c + pan4p_c --> dpcoa_c + ppi_c
ALATRS	Alanyl-tRNA synthetase	ala__L_c + atp_c + trnaala_c --> alatrna_c + amp_c + h_c + ppi_c
APL	2-Acetolactate pyruvate-lyase (carboxylating)	2ahethmpp_c + pyr_c --> alac__S_c + thmpp_c
KARA1	Ketol-acid reductoisomerase (2,3-dihydroxy-3-methylbutanoate)	alac__S_c + h_c + nadph_c --> 23dhmb_c + nadp_c
CPHL	Cephalosporin-C acetylhdrolase	cpd00679_c + h2o_c --> ac_c + cpd01995_c + h_c
DHPS	Dihydropteroate synthase	4abz_c + 6hmhpt_c --> dhpt_c + h2o_c
DHPS2_1	Dihydropteroate synthase	4abz_c + 6hmhptpp_c --> dhpt_c + h_c + ppi_c
DHQS	3-dehydroquinate synthase	2dda7p_c --> 3dhq_c + pi_c
DQDH	3-deydroquinate dehydratase	3dhq_c <=> 3dhsk_c + h2o_c
MCLORi	3-Mercaptolactate:NAD+ oxidoreductase irreversible	h_c + mercppyr_c + nadh_c --> mercplac_c + nad_c
13PPDH	1,3-propanediol dehydrogenase	3hppnl_c + h_c + nadh_c --> 13ppd_c + nad_c
SLCYSS	O-acetyl-L-serine sulfhydrylase	acser_c + tsul_c --> ac_c + h_c + selcys_c
HPS	3-hydroxypropionyl-CoA synthetase (ADP-forming)	3hpp_c + atp_c + coa_c --> 3hpcoa_c + adp_c + pi_c
UPP3S_1	Uroporphyrinogen III synthase	hmbil_c --> h2o_c + uppg3_c
DBTS	Dethiobiotin synthase	atp_c + co2_c + dann_c --> adp_c + dtbt_c + 3.0 h_c + pi_c
UACMUOR	UDP-N-acetylmuramate:NAD+ oxidoreductase	h_c + nadh_c + uaccg_c --> nad_c + uamr_c
UAPGR	UDP-N-acetylenolpyruvoylglucosamine reductase	h_c + nadph_c + uaccg_c --> nadp_c + uamr_c
UAMAS	UDP-N-acetylmuramoyl-L-alanine synthetase	ala__L_c + atp_c + uamr_c --> adp_c + h_c + pi_c + uama_c
UPP3MT	Uroporphyrinogen methyltransferase	2.0 amet_c + uppg3_c --> 2.0 ahcys_c + h_c + shcl_c
AOXSr	8-amino-7-oxononanoate synthase	ala__L_c + h_c + pmcoa_c <=> 8aonn_c + co2_c + coa_c
AHSL	O-Acetyl-L-homoserine succinate-lyase	achms_c + cys__L_c <=> ac_c + cyst_L_c + h_c
AMAOTr	Adenosylmethionine-8-amino-7-oxononanoate transaminase	8aonn_c + amet_c <=> amob_c + dann_c
PFK_2	Phosphofructokinase (tagatose, ATP)	atp_c + tag6p__D_c --> adp_c + h_c + tagdp__D_c
PFK_4	Phosphofructokinase (tagatose, CTP)	ctp_c + tag6p__D_c --> cdp_c + h_c + tagdp__D_c
PFK_5	Phosphofructokinase (tagatose, UTP)	tag6p__D_c + utp_c --> h_c + tagdp__D_c + udp_c
PFK_6	Phosphofructokinase (tagatose, ITP)	itp_c + tag6p__D_c --> h_c + idp_c + tagdp__D_c
HSTPT	Histidinol-phosphate transaminase	glu__L_c + imacp_c --> akg_c + hisp_c
SHSL1	O-Succinyl-L-homoserine succinate-lyase (adding cysteine)	cyst_L_c + h_c + succ_c <=> cys__L_c + suchms_c
PPCDC	Phosphopantothenoylcysteine decarboxylase	4ppcys_c + h_c --> co2_c + pan4p_c
TBALOR	4-Trimethylammoniobutanal:NAD+ 1-oxidoreductase	4tmeabut_c + h2o_c + nad_c --> gbbtn_c + 2.0 h_c + nadh_c
G5SD	Glutamate-5-semialdehyde dehydrogenase	glu5p_c + h_c + nadph_c --> glu5sa_c + nadp_c + pi_c
NT5C	5'-nucleotidase	h2o_c + nicrnt_c --> nicrns_c + pi_c
NICRNS	Nicotinate D-ribonucleotide synthase (ATP)	atp_c + nicrns_c --> adp_c + h_c + nicrnt_c
NNDPR	Nicotinate-nucleotide diphosphorylase (carboxylating)	h_c + prpp_c + quln_c --> co2_c + nicrnt_c + ppi_c
BGGHL	beta-D-Galactosyl-1,4-beta-D-glucosylceramide galactohydrolase	cpd00947_c + h2o_c <=> cpd00878_c + gal_c
CDP4D6DGLCRx	CDP 4 dehydro 6 deoxyglucose reductase	cdp4dh6doglc_c + h_c + nadh_c --> cdpdddg_c + h2o_c + nad_c
CDP4D6DGLCRx2	CDP 4 dehydro 6 deoxyglucose reductase (NADP)	cdp4dh6doglc_c + h_c + nadph_c --> cdpdddg_c + h2o_c + nadp_c
GTPDPDP	Guanosine-5'-triphosphate,3'-diphosphate diphosphatase	gdptp_c + h2o_c --> h_c + pi_c + ppgpp_c
AGPR	N-acetyl-g-glutamyl-phosphate reductase	acg5sa_c + nadp_c + pi_c <=> acg5p_c + h_c + nadph_c
IGPDH	Imidazoleglycerol-phosphate dehydratase	eig3p_c --> h2o_c + imacp_c
APRAUR	5-amino-6-(5-phosphoribosylamino)uracil reductase	5apru_c + h_c + nadph_c --> 5aprbu_c + nadp_c
DHPPDA2	Diaminohydroxyphosphoribosylaminopryrimidine deaminase (25drapp)	25drapp_c + h2o_c + h_c --> 5apru_c + nh4_c
PSCVT	3-phosphoshikimate 1-carboxyvinyltransferase	pep_c + skm5p_c --> 3psme_c + pi_c
DHNPA2r	Dihydroneopterin aldolase reversible	dhnpt_c --> 6hmhpt_c + gcald_c
IGPS	Indole-3-glycerol-phosphate synthase	2cpr5p_c + h_c --> 3ig3p_c + co2_c + h2o_c
PRAI	Phosphoribosylanthranilate isomerase	pran_c <=> 2cpr5p_c
NDPK10	Nucleoside-diphosphate kinase (ATP:dIDP)	atp_c + didp_c --> adp_c + ditp_c
NTPP10	Nucleoside triphosphate pyrophosphorylase (ditp)	ditp_c + h2o_c --> dimp_c + 2.0 h_c + ppi_c
ARGTRS	Arginyl-tRNA synthetase	arg__L_c + atp_c + trnaarg_c --> amp_c + argtrna_c + h_c + ppi_c
ASNTRS	Asparaginyl-tRNA synthetase	asn__L_c + atp_c + trnaasn_c --> amp_c + asntrna_c + h_c + ppi_c
CYSTRS	Cysteinyl-tRNA synthetase	atp_c + cys__L_c + trnacys_c --> amp_c + cystrna_c + h_c + ppi_c
GLNTRS	Glutaminyl-tRNA synthetase	atp_c + gln__L_c + trnagln_c --> amp_c + glntrna_c + h_c + ppi_c
GLYTRS	Glycyl-tRNA synthetase	atp_c + gly_c + trnagly_c --> amp_c + glytrna_c + h_c + ppi_c
HISTRS	Histidyl-tRNA synthetase	atp_c + his__L_c + trnahis_c --> amp_c + h_c + histrna_c + ppi_c
ILETRS	Isoleucyl-tRNA synthetase	atp_c + ile__L_c + trnaile_c --> amp_c + h_c + iletrna_c + ppi_c
LEUTRS	Leucyl-tRNA synthetase	atp_c + leu__L_c + trnaleu_c --> amp_c + h_c + leutrna_c + ppi_c
LYSTRS	Lysyl-tRNA synthetase	atp_c + lys__L_c + trnalys_c --> amp_c + h_c + lystrna_c + ppi_c
METTRS	Methionyl-tRNA synthetase	atp_c + met__L_c + trnamet_c --> amp_c + h_c + mettrna_c + ppi_c
PHETRS	Phenylalanyl-tRNA synthetase	atp_c + phe__L_c + trnaphe_c --> amp_c + h_c + phetrna_c + ppi_c
PROTRS	Prolyl-tRNA synthetase	atp_c + pro__L_c + trnapro_c --> amp_c + 2.0 h_c + ppi_c + protrna_c
SERTRS	Seryl-tRNA synthetase	atp_c + ser__L_c + trnaser_c --> amp_c + 2.0 h_c + ppi_c + sertrna_c
THRTRS	Threonyl-tRNA synthetase	atp_c + thr__L_c + trnathr_c --> amp_c + 2.0 h_c + ppi_c + thrtrna_c
TRPTRS	Tryptophanyl-tRNA synthetase	atp_c + trnatrp_c + trp__L_c --> amp_c + h_c + ppi_c + trptrna_c
VALTRS	Valyl-tRNA synthetase	atp_c + trnaval_c + val__L_c --> amp_c + h_c + ppi_c + valtrna_c
ALDH	Aldehyde dehydrogenase (NAD+)	h2o_c + mmtsa_c + nad_c --> 2.0 h_c + mm_c + nadh_c
MMHL	(R)-2-Methylmalate hydro-lyase	citm_c <=> citac_c + h2o_c
CITCIb	3-methylmalate hydratase	citac_c + h2o_c <=> r3mmal_c
GLNTRAT	Glutamyl-tRNA(Gln) amidotransferase	atp_c + gln__L_c + glutrna_gln_c + h2o_c --> adp_c + glntrna_c + glu__L_c + h_c + pi_c
HDCDH	2-hydroxyglutaryl-CoA dehydratase	glylcoa_c + h2o_c + h_c <=> hgylcoa_c
SHCHD2	Sirohydrochlorin dehydrogenase (NAD)	nad_c + shcl_c --> 2.0 h_c + nadh_c + srch_c
IPPMIb	2-isopropylmalate hydratase	3c3hmp_c <=> 2ippm_c + h2o_c
IPPMIa	3-isopropylmalate dehydratase	3c2hmp_c <=> 2ippm_c + h2o_c
PRATPP	Phosphoribosyl-ATP pyrophosphatase	h2o_c + prbatp_c --> 2.0 h_c + ppi_c + prbamp_c
PRAMPC	Phosphoribosyl-AMP cyclohydrolase	h2o_c + prbamp_c --> prfp_c
IMACTD	Imidazole acetaldeyde dehydrogenase	h2o_c + im4act_c + nad_c --> 2.0 h_c + im4ac_c + nadh_c
GLUTRR	Glutamyl-tRNA reductase	glutrna_c + h_c + nadph_c --> glu1sa_c + nadp_c + trnaglu_c
AMUAAH	N-Acetylmuramoyl-Ala amidohydrolase	acmama_c + h2o_c --> acmum_c + ala__L_c
ECH_3hivcoa	Enoyl-coa hydratase, 3-Hydroxyisovaleryl-CoA forming	3hivcoa_c <=> 3mb2coa_c + h2o_c + h_c
PPRGL	Phosphoribosylamine---glycine ligase	atp_c + gly_c + pram_c --> adp_c + gar_c + h_c + pi_c
NNDMBRT	Nicotinate-nucleotide dimethylbenzimidazole phosphoribosyltransferase	dmbzid_c + nicrnt_c --> 5prdmbz_c + h_c + nac_c
ECOAH5	3-hydroxyacyl-CoA dehydratase (3-hydroxydodecanoyl-CoA)	3hddcoa_c <=> h2o_c + trans_dd2coa_c
PSAT	Phosphoserine aminotransferase	akg_c + pser__L_c <=> 3php_c + glu__L_c
DHDRPy	Dihydrodipicolinate reductase (NADPH)	nadp_c + thdp_c <=> 23dhdp_c + h_c + nadph_c
ECOAH9ir	2 Methylprop 2 enoyl CoA  2 Methylbut 2 enoyl CoA 	3hmbcoa_c <=> 2mb2coa_c + h2o_c
PRAIS	Phosphoribosylaminoimidazole synthase	atp_c + fpram_c --> adp_c + air_c + h_c + pi_c
ASNTRAT	Aspartyl-tRNA(Asn) amidotransferase	asptrna_asn_c + atp_c + gln__L_c + h2o_c --> adp_c + asntrna_c + glu__L_c + h_c + pi_c
ACGNMCT	CTP:N-glycoloylneuraminate cytidylyltransferase	cpd02155_c + ctp_c --> cpd02319_c + h_c + ppi_c
PPNCL3	4'-Phosphopantothenate:L-cysteine ligase	4ppan_c + atp_c + cys__L_c --> 4ppcys_c + amp_c + 2.0 h_c + ppi_c
PPNCL2	Phosphopantothenate-cysteine ligase	4ppan_c + ctp_c + cys__L_c --> 4ppcys_c + cmp_c + 2.0 h_c + ppi_c
PTHPS	6-pyruvoyltetrahydropterin synthase	ahdt_c --> 6pthp_c + pppi_c
QULNS	Quinolinate synthase	dhap_c + iasp_c --> 2.0 h2o_c + h_c + pi_c + quln_c
GARFT	Phosphoribosylglycinamide formyltransferase	10fthf_c + gar_c --> fgam_c + h_c + thf_c
FGFTh	N2-Formyl-N1-(5-phospho-D-ribosyl)glycinamide formyltransferase, chloroplast	gar_c + h2o_c + methf_c --> fgam_c + 2.0 h_c + thf_c
KAS14	Beta-ketoacyl-ACP synthase	acACP_c + h_c + malACP_c --> ACP_c + actACP_c + co2_c
ADPT2	Adenine phosphoribosyltransferase	aicar_c + h_c + ppi_c <=> cpd02506_c + prpp_c
APCPT	ATP:pantothenoyl-L-cysteine 4'-phosphotransferase	atp_c + ptcys_c --> 4ppcys_c + adp_c + h_c
R04399	Placeholder	cpd02544_c <=> cpd02653_c + h2o_c
MTRI	5-methylthioribose-1-phosphate isomerase	5mdr1p_c <=> 5mdru1p_c
IPMD	3-isopropylmalate dehydrogenase	3c2hmp_c + nad_c <=> 3c4mop_c + h_c + nadh_c
3HAD40_1	3-hydroxyacyl-[acyl-carrier-protein] dehydratase (n-C4:0)	3hbutACP_c <=> but2eACP_c + h2o_c
EAR40x	Enoyl-[acyl-carrier-protein] reductase (NADH) (n-C4:0	butACP_c + nad_c <=> but2eACP_c + h_c + nadh_c
ACNAM9PL	N-Acetylneuraminate 9-phosphate pyruvate-lyase (pyruvate-phosphorylating)	acmanap_c + h2o_c + h_c + pep_c --> acnamp_c + pi_c
KARI_23dhmb	Ketol-acid reductoisomerase, (R)-2,3-Dihydroxy-3-methylbutanoate forming	23dhmb_c + nadp_c <=> 3hmoa_c + h_c + nadph_c
DLDLBT	6,7-Dimethyl-8-(1-D-ribityl)lumazine:6,7-dimethyl-8-(1-D-ribityl) lumazine 2,3-butanediyltransferase	4r5au_c + db4p_c --> dmlz_c + 2.0 h2o_c + pi_c
PRFGS	Phosphoribosylformylglycinamidine synthase	atp_c + fgam_c + gln__L_c + h2o_c --> adp_c + fpram_c + glu__L_c + h_c + pi_c
ADAPAT	E N-acetyl-L,L-diaminopimelate aminotransferase	glu__L_c + nal2a6o_c --> akg_c + n6all26d_c
SDPTA	Succinyldiaminopimelate transaminase	akg_c + sl26da_c <=> glu__L_c + sl2a6o_c
3OAR40	3-oxoacyl-[acyl-carrier-protein] reductase (n-C4:0)	3hbutACP_c + nadp_c <=> actACP_c + h_c + nadph_c
3OAR100	3-oxoacyl-[acyl-carrier-protein] reductase (n-C10:0)	3hdecACP_c + nadp_c <=> 3odecACP_c + h_c + nadph_c
3HAD100	3-hydroxyacyl-[acyl-carrier-protein] dehydratase (n-C10:0)	3hdecACP_c <=> h2o_c + tdec2eACP_c
3OAR80	3-oxoacyl-[acyl-carrier-protein] reductase (n-C8:0)	3hoctACP_c + nadp_c <=> 3ooctACP_c + h_c + nadph_c
3HAD80	3-hydroxyacyl-[acyl-carrier-protein] dehydratase (n-C8:0)	3hoctACP_c + h_c <=> h2o_c + toct2eACP_c
3OAR160	3-oxoacyl-[acyl-carrier-protein] reductase (n-C16:0)	3hpalmACP_c + nadp_c <=> 3opalmACP_c + h_c + nadph_c
3HAD160	3-hydroxyacyl-[acyl-carrier-protein] dehydratase (n-C16:0)	3hpalmACP_c <=> h2o_c + tpalm2eACP_c
IG3PS	Imidazole-glycerol-3-phosphate synthase	gln__L_c + prlp_c --> aicar_c + eig3p_c + glu__L_c + h_c
ADSL2r	Adenylosuccinate lyase	25aics_c <=> aicar_c + fum_c + h_c
AICART	Phosphoribosylaminoimidazolecarboxamide formyltransferase	10fthf_c + aicar_c <=> fprica_c + thf_c
3OAR140	3-oxoacyl-[acyl-carrier-protein] reductase (n-C14:0)	3hmrsACP_c + nadp_c <=> 3omrsACP_c + h_c + nadph_c
3HAD140	3-hydroxyacyl-[acyl-carrier-protein] dehydratase (n-C14:0)	3hmrsACP_c <=> h2o_c + tmrs2eACP_c
UGLDDS2	UDP-N-acetylmuramoyl-L-alanyl-D-glutamyl-L-lysyl-D-alanyl-D-alanine synthetase (gamma-glutamate)	atp_c + diala__L_c + uGgl_c --> adp_c + h_c + pi_c + uGgla_c
PRASCSi	Phosphoribosylaminoimidazolesuccinocarboxamide synthase	5aizc_c + asp__L_c + atp_c --> 25aics_c + adp_c + h_c + pi_c
RZ5PP	Alpha-ribazole 5-phosphate phosphatase	5prdmbz_c + h2o_c --> pi_c + rdmbzi_c
UGMDDS	UDP-N-acetylmuramoyl-L-alanyl-D-glutamyl-meso-2,6-diaminopimeloyl-D-alanyl-D-alanine synthetase	atp_c + diala__L_c + ugmd_c --> adp_c + h_c + pi_c + ugmda_c
AHDTPHL	2-Amino-4-hydroxy-6-(erythro-1,2,3-trihydroxypropyl) dihydropteridine triphosphate 7,8-8,9-dihydrolase Folate biosynthesis EC:3.5.4.16	ahdt_c + h2o_c --> cpd03666_c
PRMICI	1-(5-phosphoribosyl)-5-[(5-phosphoribosylamino)methylideneamino)imidazole-4-carboxamide isomerase	prfp_c --> prlp_c
ACAS_2ahbut	Acetolactate synthase, 2-Aceto-2-hydroxybutanoate forming	2ahethmpp_c + 2obut_c --> 2ahbut_c + thmpp_c
EAR120x	Enoyl-[acyl-carrier-protein] reductase (NADH) (n-C12:0)	ddeacp_c + nad_c <=> h_c + nadh_c + tddec2eACP_c
3OAS140	3-oxoacyl-[acyl-carrier-protein] synthase (n-C14:0)	ddeacp_c + h_c + malACP_c --> 3omrsACP_c + ACP_c + co2_c
ECOAH7	3 hydroxyacyl CoA dehydratase  3 hydroxyhexadecanoyl CoA 	3hhdcoa_c <=> h2o_c + hdd2coa_c
ECOAH6	3-hydroxyacyl-CoA dehydratase (3-hydroxytetradecanoyl-CoA)	3htdcoa_c <=> h2o_c + td2coa_c
ECOAH4	3 hydroxyacyl CoA dehydratase  3 hydroxydecanoyl CoA	3hdcoa_c <=> dc2coa_c + h2o_c
ECOAH3	3-hydroxyacyl-CoA dehydratase (3-hydroxyoctanoyl-CoA)	3hocoa_c <=> h2o_c + oc2coa_c
ECOAH2	3-hydroxyacyl-CoA dehydratase (3-hydroxyhexanoyl-CoA)	3hhcoa_c <=> h2o_c + hx2coa_c
KLCGH	3-Ketolactose galactohydrolase	cpd03199_c + h2o_c <=> cpd03193_c + glc__D_c
AHSERL4	Cysteine synthase Thiosulfate	acser_c + trdrd_c + tsul_c --> ac_c + cys__L_c + h_c + so3_c + trdox_c
34DHOXPEGOX	3,4-Dihydroxyphenylethyleneglycol NAD+ oxidoreductase	34dhoxpeg_c + nad_c <=> 34dhmald_c + h_c + nadh_c
HIALOR	5-Hydroxyindoleacetaldehyde:NAD+ oxidoreductase	5hoxindact_c + h2o_c + nad_c <=> 5hoxindoa_c + 2.0 h_c + nadh_c
CGGH	Cyanoglycoside glucohydrolase	cpd12755_c + h2o_c --> cpd12754_c + glc__D_c
3OAS60	3-oxoacyl-[acyl-carrier-protein] synthase (n-C6:0)	butACP_c + h_c + malACP_c --> 3ohexACP_c + ACP_c + co2_c
3OAR60	3-oxoacyl-[acyl-carrier-protein] reductase (n-C6:0)	3hhexACP_c + nadp_c <=> 3ohexACP_c + h_c + nadph_c
3HAD60	3-hydroxyacyl-[acyl-carrier-protein] dehydratase (n-C6:0)	3hhexACP_c <=> h2o_c + thex2eACP_c
EAR60x	Hexanoyl-[acyl-carrier protein]:malonyl-CoA C-acyltransferase(decarboxylating, oxoacyl- and enoyl-reducing)	hexACP_c + nad_c <=> h_c + nadh_c + thex2eACP_c
3OAS80	hexanoyl-[acyl-carrier protein]:malonyl-[acyl-carrier-protein] C-acyltransferase (decarboxylating)	hexACP_c + malACP_c --> 3ooctACP_c + ACP_c + co2_c
EAR80x	Octanoyl-[acyl-carrier protein]:malonyl-CoA C-acyltransferase(decarboxylating, oxoacyl- and enoyl-reducing)	nad_c + ocACP_c <=> h_c + nadh_c + toct2eACP_c
3OAS100	Octanoyl-[acyl-carrier protein]:malonyl-[acyl-carrier-protein] C-acyltransferase (decarboxylating)	h_c + malACP_c + ocACP_c --> 3odecACP_c + ACP_c + co2_c
EAR100x	Decanoyl-[acyl-carrier protein]:malonyl-CoA C-acyltransferase(decarboxylating, oxoacyl- and enoyl-reducing)	deceACP_c + nad_c <=> h_c + nadh_c + tdec2eACP_c
3OAS120	Decanoyl-[acyl-carrier protein]:malonyl-[acyl-carrier-protein] C-acyltransferase (decarboxylating)	deceACP_c + h_c + malACP_c --> 3oddecACP_c + ACP_c + co2_c
3OAR120	3-oxoacyl-[acyl-carrier-protein] reductase (n-C12:0)	3hddecACP_c + nadp_c <=> 3oddecACP_c + h_c + nadph_c
3HAD120	3-hydroxyacyl-[acyl-carrier-protein] dehydratase (n-C12:0)	3hddecACP_c <=> h2o_c + tddec2eACP_c
EAR140x	Tetradecanoyl-[acyl-carrier protein]:malonyl-CoA C-acyltransferase(decarboxylating, oxoacyl- and enoyl-reducing)	nad_c + tdeceACP_c <=> h_c + nadh_c + tmrs2eACP_c
3OAS160	Tetradecanoyl-[acyl-carrier protein]:malonyl-[acyl-carrier-protein] C-acyltransferase (decarboxylating)	h_c + malACP_c + tdeceACP_c --> 3opalmACP_c + ACP_c + co2_c
HACPMCACT	Hexadecanoyl-[acyl-carrier protein]:malonyl-CoA C-acyltransferase(decarboxylating, oxoacyl- and enoyl-reducing)	hexdACP_c + nad_c <=> h_c + nadh_c + tpalm2eACP_c
BDG2HCGHD	Beta-D-Glucosyl-2-coumarinate glucohydrolase	bdg2hc_c + h2o_c <=> 2coum_c + glc__D_c
UAGPT3	UDP-N-acetyl-D-glucosamine:undecaprenyl-diphospho-N-acetylmuramoyl-L-alanyl-gamma-D-glutamyl-meso-2,6-diaminopimeloyl-D-alanyl-D-alanine 4-beta-N-acetylglucosaminlytransferase	uacgam_c + uagmda_c --> uaagmda_c + udp_c
FANTPDH	Formamidopyrimidine nucleoside triphosphate 7,8-8,9-dihydrolase Folate biosynthesis EC:3.5.4.16	cpd03518_c + h2o_c --> cpd03519_c + for_c + h_c
APNTPM	2,5-Diaminopyrimidine nucleoside triphosphate mutase	cpd03519_c <=> cpd03666_c
NABTNO	N4 AcetylaminobutanalNAD oxidoreductase	h2o_c + n4abutn_c + nad_c <=> 4aabutn_c + 2.0 h_c + nadh_c
EHGLAT	L erythro 4 Hydroxyglutamate2 oxoglutarate aminotransferase	4hglu_c + akg_c <=> 4h2oglt_c + glu__L_c
KARI_23dhmp	Ketol-acid reductoisomerase, (R)-2,3-Dihydroxy-3-methylpentanoate forming	23dhmp_c + nadp_c <=> cpd10162_c + h_c + nadph_c
KARI	Ketol-acid reductoisomerase	2ahbut_c <=> cpd10162_c
KARI_3hmoa	Ketol-acid reductoisomerase,  3-Hydroxy-3-methyl-2-oxobutanoic acid forming	alac__S_c <=> 3hmoa_c
PP2MO	R05078	cpd02570_c <=> cpd03596_c + h2o_c
OHPBAT	O-Phospho-4-hydroxy-L-threonine:2-oxoglutarate aminotransferase	akg_c + phthr_c <=> glu__L_c + ohpb_c
4HTHRS	4-Hydroxy-L-threonine synthase	h2o_c + phthr_c --> 4hthr_c + pi_c
NO2OR	reduced ferredoxin:dinitrogen oxidoreductase (ATP-hydrolysing)	16.0 atp_c + 8.0 fdxr_42_c + 16.0 h2o_c + n2_c --> 16.0 adp_c + 8.0 fdxo_42_c + h2_c + 6.0 h_c + 2.0 nh4_c + 16.0 pi_c
CYRDAAT	Cob(I)yrinic acid a,c-diamide adenosyltransferase	atp_c + co1dam_c + h_c --> adcobdam_c + pppi_c
ADOCBIK	Adenosyl cobinamide kinase	adocbi_c + atp_c --> adocbip_c + adp_c + h_c
ACBIPGT	Adenosyl cobinamide phosphate guanyltransferase	adocbip_c + gtp_c <=> agdpcbi_c + h_c + ppi_c
ADOCBLS	Adenosylcobalamin 5'-phosphate synthase	agdpcbi_c + rdmbzi_c --> adocbl_c + gmp_c + h_c
G1PACT	Glucosamine-1-phosphate N-acetyltransferase	accoa_c + gam1p_c --> acgam1p_c + coa_c + h_c
SMLSHL	4-sulfomuconolactone sulfohydrolase	cpd04077_c + h2o_c <=> cpd01498_c + h_c + so3_c
ASPTRS	Aspartyl-tRNA synthetase	asp__L_c + atp_c + trnaasp_c --> amp_c + asptrna_c + h_c + ppi_c
GLUTRS	Glutamyl-tRNA synthetase	atp_c + glu__L_c + trnaglu_c --> amp_c + glutrna_c + h_c + ppi_c
ECOAH2c2	Enoyl CoA hydratase bacterial	cpd04111_c + h2o_c <=> 3hpimcoa_c
R05602	R05602	6hch1eccoa_c + h2o_c <=> cpd06716_c
DHNAOT4	1,4-dihydroxy-2-naphthoate octaprenyltransferase	dhna_c + octdp_c --> 2dmmq_gen_c + co2_c + h_c + ppi_c
UPPPHL	undecaprenyl-diphosphate phosphohydrolase	h2o_c + udcpdp_c --> 2.0 h_c + pi_c + udcpp_c
UDCP	UDPMurAc(oyl-L-Ala-D-gamma-Glu-L-Lys-D-Ala-D-Ala):undecaprenyl-phosphate phospho-N-acetylmuramoyl-pentapeptide-transferase	uGgla_c + udcpp_c --> uaGgla_c + ump_c
UDCPT	UDP-N-acetylmuramoyl-L-alanyl-gamma-D-glutamyl-meso-2,6-diaminopimeloyl-D-alanyl-D-alanine:undecaprenyl-phosphate phospho-N-acetylmuramoyl-pentapeptide-transferase	udcpp_c + ugmda_c --> uagmda_c + ump_c
CMS	2-C-methyl-D-erythritol 4-phosphate cytidylyltransferase	2me4p_c + ctp_c --> 4c2me_c + ppi_c
CDPMEK	4-(cytidine 5'-diphospho)-2-C-methyl-D-erythritol kinase	4c2me_c + atp_c --> 2p4c2me_c + adp_c + h_c
DXPS	1-deoxy-D-xylulose 5-phosphate synthase	g3p_c + h_c + pyr_c --> co2_c + dxyl5p_c
MCS	2-C-methyl-D-erythritol 2,4-cyclodiphosphate synthase	2p4c2me_c --> 2mecdp_c + cmp_c
UAGPT2	UDP-N-acetylglucosamine-N-acetylmuramyl-(pentapeptide)pyrophosphoryl-undecaprenol N-acetylglucosamine transferase	uaGgla_c + uacgam_c --> uaaGgla_c + udp_c
HTHRPDH	4-hydroxythreonine-4-phosphate dehydrogenase	nad_c + phthr_c <=> amopbut-L_c + h_c + nadh_c
DXRI	1-deoxy-D-xylulose-5-phosphate reductoisomerase	dxyl5p_c + h_c + nadph_c --> 2me4p_c + nadp_c
IPDOR	isopentenyl-diphosphate:NAD(P)+ oxidoreductase	h2mb4p_c + h_c + nadph_c --> h2o_c + ipdp_c + nadp_c
LACZ	B-galactosidase	h2o_c + lcts_c --> gal_c + glc__D_c
PYLALDOX	Perillyl aldehyde:NAD+ oxidoreductase	h2o_c + nad_c + pylald_c <=> 2.0 h_c + nadh_c + peracd_c
PAACOAL	perillic acid:CoA ligase (ADP-forming)	atp_c + coa_c + peracd_c --> adp_c + percoa_c + pi_c
HICHCOAL	2-hydroxy-4-isopropenylcyclohexane-1-carboxyl-CoA hydro-lyase	h2o_c + percoa_c <=> cpd08731_c
IPOCOAL	(3R)-3-isopropenyl-6-oxoheptanoate:CoA ligase (ADP-forming)	3ipro6oxhp_c + atp_c + coa_c --> 3ipro6oxhpcoa_c + adp_c + pi_c
CMIPDCOAL	cis-2-Methyl-5-isopropylhexa-2,5-dienoate-CoA ligase	atp_c + c2m26d_c + coa_c --> amp_c + c2m26dcoa_c + h_c + ppi_c
TMIPDCOAL	trans-2-Methyl-5-isopropylhexa-2,5-dienoate-CoA ligase	atp_c + coa_c + t2m26d_c --> amp_c + h_c + ppi_c + t2m26dcoa_c
UDCPDPS	Undecaprenyl diphosphate synthase	frdp_c + 8.0 ipdp_c --> 8.0 h_c + 8.0 ppi_c + udcpdp_c
TDPGDH	DTDPglucose 4,6-dehydratase	dtdpglu_c --> dtdp4d6dg_c + h2o_c
TDPDRE	DTDP-4-dehydrorhamnose 3,5-epimerase	dtdp4d6dg_c --> dtdp4d6dm_c
IPOHCOAL	(3R)-3-isopropenyl-6-oxoheptanoate:CoA ligase (AMP-forming)	3ipro6oxhp_c + atp_c + coa_c --> 3ipro6oxhpcoa_c + amp_c + h_c + ppi_c
ADCPS2	Adenosylcobinamide-phosphate synthase	adcobhex_c + applp_c + atp_c --> adocbip_c + adp_c + h_c + pi_c
ADOCBIK2	adenosylcobinamide kinase	adocbi_c + gtp_c --> adocbip_c + gdp_c + h_c
SALMCCOAMT	S-adenosyl-L-methionine:caffeoyl-CoA 3-O-methyltransferase	5hfreulcoa_c + amet_c <=> ahcys_c + h_c + sincoa_c
EGMEST	Ecgonine methyl esterase	egme_c + h2o_c --> ecgon_c + meoh_c
PECGONCOAT	Pseudoecgonyl-CoA synthase	atp_c + coa_c + pecgon_c --> amp_c + h_c + pecgoncoa_c + ppi_c
QUOR	L-quinate:NADP+ 3-oxidoreductase	3dhq_c + h_c + nadph_c --> nadp_c + quin_kt_c
SHOR	shikimate:NAD+ 3-oxidoreductase	3dhsk_c + h_c + nadh_c --> nad_c + skm_c
BHPR	1,2-bis(4-hydroxyphenyl)-2-proponol reductase	cpd09480_c <=> cpd09483_c + h2o_c
UAGDH	UDP-N-acetyl-D-galactosamine dehydrogenase	h2o_c + 2.0 nad_c + udpacgal_c <=> 3.0 h_c + 2.0 nadh_c + uagnr_c
CPPPGO2	Oxygen Independent coproporphyrinogen-III oxidase	2.0 amet_c + cpppg3_c --> 2.0 co2_c + 2.0 dad_5_c + 2.0 met__L_c + pppg9_c
NHMSCOAH	Naphthyl-2-hydroxymethylsuccinyl-CoA hydratase	cpd09820_c + h2o_c <=> cpd09821_c
HMBPAL	2-hydroxy-3-methylbenzalpyruvate hydratase-aldolase	cpd09789_c + h2o_c --> cpd09790_c + pyr_c
HMNOR	1-hydroxymethylnaphthalene:NAD+ oxidoreductase	cpd09792_c + nad_c <=> cpd09793_c + h_c + nadh_c
HCBPHAL	2-hydroxy-3-carboxy-benzalpyruvate hydratase-aldolase	cpd09798_c + h2o_c --> cpd09799_c + pyr_c
NMOR	(2-naphthyl)methanol:NAD+ oxidoreductase	cpd01859_c + nad_c <=> cpd09802_c + h_c + nadh_c
HOMBPAL	2-hydroxy-4-hydroxymethylbenzalpyruvate hydratase-aldolase	cpd09810_c + h2o_c --> cpd09811_c + pyr_c
HADCPCOAHL	(3S)-3-hydroxyacyl-CoA hydro-lyase	cpd09843_c + h2o_c <=> 3hadpcoa_c + h_c
ADPCOAL	Adipate-CoA ligase	atp_c + coa_c + cpd03642_c --> amp_c + cpd09842_c + ppi_c
OBTFL	2-Oxobutanoate formate lyase	2obut_c + coa_c --> for_c + ppcoa_c
VOR2b	3-methyl-2-oxobutanoate dehydrogenase (ferredoxin)	3mob_c + coa_c + 2.0 fdxo_42_c --> co2_c + 2.0 fdxr_42_c + h_c + ibcoa_c
MTHFO	5-methyltetrahydrofolate:NAD+ oxidoreductase	h_c + mlthf_c + nadh_c --> 5mthf_c + nad_c
IDS2	Dimethylallyl-diphosphate synthase	h2mb4p_c + nadph_c --> dmpp_c + h2o_c + nadp_c
CBIAT	Cobinamide adenyltransferase	atp_c + cbi_c + h_c --> adocbi_c + pppi_c
DB4PS	3,4-Dihydroxy-2-butanone-4-phosphate synthase	ru5p__D_c --> db4p_c + for_c + h_c
ADCPS1	Adenosylcobinamide-phosphate synthase	adcobhex_c + appl_c + atp_c --> adocbi_c + adp_c + h_c + pi_c
CLS	cardiolipin synthase	2.0 pg_SC_c --> clpn_SC_c + glyc_c
CITMS	Citramalate synthase	accoa_c + h2o_c + pyr_c --> citm_c + coa_c + h_c
AIRC3	Phosphoribosylaminoimidazole carboxylase (mutase rxn)	5caiz_c + h_c --> 5aizc_c
THISAT	ThiS adenylyltransferase sulfur carrier protein	SCP_c + atp_c --> adenSCP_c + ppi_c
CYSDES	Cysteine desulfurase	cpd27355_c + cys__L_c --> ala__L_c + cpd27847_c
LDAPAT	LL-diaminopimelate aminotransferase	26dap_LL_c + akg_c <=> glu__L_c + h2o_c + h_c + thdp_c
UDPKAAT	UDP-4''-ketopentose:UDP-4-amino-4-deoxy-L-arabinose aminotransferase	glu__L_c + udpLa4o_c --> akg_c + udpLa4n_c
RE0581R	very-long-chain 3-oxoacyl-CoA reductase	3oodcoa_c + h_c + nadph_c --> 3hodcoa_c + nadp_c
FASOXST	fatty acid synthase	h_c + hexdACP_c + malACP_c --> 3osteACP_c + ACP_c + co2_c
3OAR18B	3-oxoacyl-[acyl-carrier protein] reductase	3osteACP_c + h_c + nadph_c <=> 3hoctaACP_c + nadp_c
3HAD180	3-hydroxyacyl-[acyl-carrier-protein] dehydratase (n-C18:0)	3hoctaACP_c <=> h2o_c + toctd2eACP_c
FASOD	fatty acid synthase octadecanoylACP	h_c + nadh_c + toctd2eACP_c <=> nad_c + ocdACP_c
CPCOAL	cyclopropanecarboxylate:CoA ligase	atp_c + coa_c + cproc_c --> adp_c + cproccoa_c + pi_c
GGT	GTP:GTP guanylyltransferase	2.0 gtp_c <=> 35cdgmp_c + 2.0 h_c + 2.0 ppi_c
MHECOAHL	3-hydroxy-5-methylhex-4-enoyl-CoA hydro-lyase	cpd15172_c + h2o_c <=> cpd15173_c
IPDPS	1-hydroxy-2-methyl-2-(E)-butenyl 4-diphosphate reductase (ipdp)	h2mb4p_c + h_c + nadh_c --> h2o_c + ipdp_c + nad_c
DMPPS	1-hydroxy-2-methyl-2-(E)-butenyl 4-diphosphate reductase (dmpp)	h2mb4p_c + h_c + nadh_c --> dmpp_c + h2o_c + nad_c
SERTRS2	Seryl-tRNA synthetase	atp_c + ser__L_c + trnasec_c --> amp_c + ppi_c + sertrna_sec_c
5FLURAPRT2	5-fluorouracil phosphoribosyltransferase	5flur_c + atp_c --> 5flurimp_c + adp_c + h_c
6TINS5MPOR	6-thioinosine 5'-monophosphate:NAD oxidoreductase	6tins5mp_c + h2o_c + nad_c --> 6txan5mp_c + h_c + nadh_c
6TXAN5MPAML	6-thioxanthine 5'-monophosphate:L-glutamine amido-ligase	6txan5mp_c + atp_c + gln__L_c + h2o_c --> 6tgsnmp_c + amp_c + glu__L_c + 3.0 h_c + ppi_c
RPYS	D-ribose pyranase	cpd05267_c <=> cpd16443_c
APCS	Aminopropylcadaverine synthase	15dap_c + ametam_c --> 5mta_c + h_c + na15dap_c
VOR1b	4-methyl-2-oxopentaoate dehydrogenase (ferredoxin)	4mop_c + coa_c + 2.0 fdxo_42_c --> co2_c + 2.0 fdxr_42_c + h_c + ivcoa_c
VOR3b	3-methyl-2-oxobutanoate dehydrogenase (ferredoxin)	3mop_c + coa_c + 2.0 fdxo_42_c --> 2mbcoa_c + co2_c + 2.0 fdxr_42_c + h_c
GLYCK2	Glycerate kinase	atp_c + glyc__R_c --> 2pg_c + adp_c + h_c
PGMT	Phosphoglucomutase	g1p_c <=> g6p_c
HMBDPO	4-hydroxy-3-methylbut-2-en-1-yl-diphosphate:oxidized ferredoxin oxidoreductase	2mecdp_c + 2.0 fdxr_42_c + 2.0 h_c --> 2.0 fdxo_42_c + h2mb4p_c + h2o_c
CDGUNPD	3,5-cyclic-nucleotide phosphodiesterase	35cdgmp_c + h2o_c <=> 5pg35pg_c + h_c
MCMMT	methanol:coenzyme M methyltransferase	com_c + meoh_c <=> h2o_c + mcom_c
GLYHMT	5,10-methylenetetrahydromethanopterin:glycine hydroxymethyltransferase	h4mpt_c + ser__L_c <=> gly_c + h2o_c + mleneh4spt_c
HPHBHL	4-hydroxyphenyl-4-hydroxybenzoate hydrolase	4hp4hob_c + h2o_c <=> 4hbz_c + h_c + hqn_c
TMAMT	trimethylamine:coenzyme M methyltransferase	com_c + tma_c <=> dma_c + mcom_c
HEPDPS	Heptaprenyl pyrophosphate synthase	frdp_c + 4.0 ipdp_c --> 4.0 h_c + hepdp_c + 4.0 ppi_c
OCTDPS	Octaprenyl pyrophosphate synthase	frdp_c + 5.0 ipdp_c --> 5.0 h_c + octdp_c + 5.0 ppi_c
TRNACCAT	CTP,CTP,ATP:tRNA cytidylyl,cytidylyl,adenylyltransferase	atp_c + 2.0 ctp_c + trnaprec_c --> 3.0 ppi_c + trnacca_c
TRNACTPAT	CTP:tRNA cytidylyltransferase	ctp_c + trnaprec_c --> h_c + ppi_c + trnacyt_c
TRNACTPAT2	CTP:tRNA cytidylyltransferase	ctp_c + h_c + trnacyt_c --> 6.0 h2o_c + ppi_c + trnacc_c
TRNAATPAT	ATP:tRNA adenylyltransferase	atp_c + 6.0 h2o_c + trnacc_c --> ppi_c + trnacca_c
BTDD_M	meso-2,3-butanediol:NAD+ oxidoreductase	cpd00361_c + h_c + nadh_c --> btd_M_c + nad_c
RNF	Ferredoxin:NAD oxidoreductase (membrane bound)	2.0 fdxr_42_c + 2.0 h_c + nad_c <=> 2.0 fdxo_42_c + h_e + nadh_c
H2ASE_syn	Bidirectional [NiFe] Hydrogenase (Fe-H2)	h2_c + nadp_c <=> h_c + nadph_c
BIF	Bifurcating Hydrogenase	2.0 fdxr_42_c + 3.0 h_c + nadh_c <=> 2.0 fdxo_42_c + 2.0 h2_c + nad_c
FRNDPR2r	Ferredoxin : nadp reductase (NFN)	2.0 fdxr_42_c + h_c + nadh_c + 2.0 nadp_c <=> 2.0 fdxo_42_c + nad_c + 2.0 nadph_c
FBA	Fructose-bisphosphate aldolase	fdp_c <=> dhap_c + g3p_c
MDH	Malate dehydrogenase	mal__L_c + nad_c <=> h_c + nadh_c + oaa_c
PGK2	GTP dependent Phosphoglycerate kinase	13dpg_c + gdp_c --> 3pg_c + gtp_c
TKT1	Transketolase	g3p_c + s7p_c <=> r5p_c + xu5p__D_c
TKT2	Transketolase	f6p_B_c + g3p_c <=> e4p_c + xu5p__D_c
ATPHs	ATP amine hydrolysis (spontaneous)	atp_c + h2o_c + h_c --> itp_c + nh4_c
FE2OR	Fe2+:NAD+ oxidoreductase;	2.0 fe3_c + nadh_c --> 2.0 fe2_c + h_c + nad_c
ADMDC	Adenosylmethionine decarboxylase	amet_c + h_c --> ametam_c + co2_c
GLUR	Glutamate racemase	glu__L_c <=> glu__D_c
UDPGD	UDPglucose 6-dehydrogenase	h2o_c + 2.0 nad_c + udpg_c --> 3.0 h_c + 2.0 nadh_c + udpglcur_c
ORNDC	Ornithine Decarboxylase	h_c + orn__L_c --> co2_c + ptrc_c
PAL	L-phenylalanine ammonia-lyase (trans-cinnamate-forming)	phe__L_c --> cinnm_c + nh4_c
GMAND	GDP-D-mannose dehydratase	gdpmann_c <=> gdpddman_c + h2o_c
CYSOR		2.0 cys__L_c + nad_c <=> Lcystin_c + h_c + nadh_c
MMSDH	Methylmalonate-semialdehyde dehydrogenase (acylating)	coa_c + mmtsa_c + nad_c --> co2_c + nadh_c + ppcoa_c
OMPDC	Orotidine-5'-phosphate decarboxylase	h_c + orot5p_c --> co2_c + ump_c
GLYCDH	Glycerol dehydratase	glyc_c --> 3hppnl_c + h2o_c
R5PAT	ADP:D-ribose-5-phosphate adenylyltransferase	adp_c + r5p_c --> adprib_c + pi_c
HISDC	Histidine decarboxylase	h_c + his__L_c --> co2_c + hista_c
PPYRDC	Phenylpyruvate decarboxylase	h_c + phpyr_c --> co2_c + pacald_c
HDHL	hexadecanoyl-[acyl-carrier protein] hydrolase	h2o_c + hexdACP_c --> ACP_c + h_c + hdca_c
E4PD	Erythrose 4-phosphate dehydrogenase	e4p_c + h2o_c + nad_c --> 4per_c + 2.0 h_c + nadh_c
ORPT	Orotate phosphoribosyltransferase	h_c + orot5p_c + ppi_c <=> orot_c + prpp_c
F1PGT	Fucose-1-phosphate guanylyltransferase	fc1p_c + gtp_c --> gdpfuc_c + ppi_c
ACGAM6PS	N acetylglucosamine 6 phosphate synthase	accoa_c + gam6p_c --> acgam6p_c + coa_c + h_c
DGK1	Deoxyguanylate kinase (dGMP:ATP)	atp_c + dgmp_c + h_c --> adp_c + dgdp_c
DTMPK	DTMP kinase	atp_c + dtmp_c + h_c --> adp_c + dtdp_c
PPDOy	Propane-1,2-diol:NADP+ 1-oxidoreductase	12ppd__R_c + nadp_c <=> h_c + lald__L_c + nadph_c
PPDHL	propane-1,2-diol hydro-lyase	12ppd__R_c --> h2o_c + ppal_c
ALDD19xr	Aldehyde dehydrogenase (phenylacetaldehyde, NAD)	h2o_c + nad_c + pacald_c --> h_c + nadh_c + pac_c
UAAGLS2	UDP-N-acetylmuramoyl-L-alanyl-D-glutamyl-L-lysine synthetase (gamma-glutamate)	atp_c + lys__L_c + uamag_c --> adp_c + h_c + pi_c + uGgl_c
DACPAT	acetyl-CoA:deacetylcephalosporin-C O-acetyltransferase	coa_c + cpd00679_c <=> accoa_c + cpd01995_c
FCLK	L-fuculokinase	atp_c + fuc__L_c --> adp_c + fc1p_c + h_c
PRAICL	1-(5-phospho-D-ribosyl)-5-amino-4-imidazolecarboxylate carboxy-lyase	air_c + co2_c --> 5aizc_c + h_c
PERD	Erythronate 4-phosphate (4per) dehydrogenase	4per_c + nad_c --> h_c + nadh_c + ohpb_c
THPAT	L-2,3,4,5-tetrahydrodipicolinate N2-acetyltransferase	accoa_c + h2o_c + thdp_c --> coa_c + nal2a6o_c
MS	5-methyltetrahydropteroyltriglutamate---homocysteine S-methyltransferase	hcys__L_c + mhpglu_c --> met__L_c + thglu_c
GLNSP2	Glutamine synthetase (uaaGgla)	atp_c + nh4_c + uaaGgla_c --> adp_c + h_c + pi_c + uaaGgtla_c
GFUCS	GDP-L-fucose synthase	gdpfuc_c + nadp_c <=> gdpddman_c + h_c + nadph_c
UG6PGT	UDP-glucose + D-Glucose 6-phosphate => UDP + Trehalose 6-phosphate	g6p_c + udpg_c --> tre6p_c + udp_c
UDPGDC	UDP-glucuronate C-4'' decarboxylase	nad_c + udpglcur_c --> co2_c + nadh_c + udpLa4o_c
3OACOAS	3-oxoacyl-CoA synthase (18:0)	h_c + malcoa_c + pmtcoa_c --> 3oodcoa_c + co2_c + coa_c
TRNAGLYUDAT	glycyl-tRNA:undecaprenyl-diphospho-N-acetylmuramoyl-(N-acetylglucosamine)-L-alanyl-D-isoglutaminyl-L-lysyl-D-alanyl-D-alanine N6-glycyltransferase	glytrna_c + uaaGgtla_c --> h_c + trnagly_c + udecan1_c
TRNAALAUDAT	L-alanyl-tRNA:undecaprenyl-diphospho-N-acetylmuramoyl-(N-acetylglucosamine)-L-alanyl-gamma-D-glutamyl-L-lysyl-D-alanyl-D-alanine N6-alanyltransferase	alatrna_c + uaaGgla_c --> h_c + trnaala_c + udecan2_c
OMCDC	2-Oxo-4-methyl-3-carboxypentanoate decarboxylation	3c4mop_c + h_c --> 4mop_c + co2_c
AACPS3MBUT	Acyl-[acyl-carrier-protein] synthetase (3-Methylbutanoyl-CoA)	ACP_c + ivcoa_c <=> 3mbACP_c + coa_c
SKK	Shikimate kinase	atp_c + skm_c --> adp_c + h_c + skm5p_c
G5SADs	L-glutamate 5-semialdehyde dehydratase (spontaneous)	glu5sa_c <=> 1pyr5c_c + h2o_c + h_c
HSK	Homoserine kinase	atp_c + hom__L_c --> adp_c + h_c + phom_c
GLCS1	Glycogen synthase (ADPGlc)	adpglc_c --> adp_c + glycogen_c
GLCP	Glycogen phosphorylase	glycogen_c + pi_c --> g1p_c
AACPS3MCR	3-Methylcrotonyl-CoA: ACP transacylase	3mb2coa_c + ACP_c <=> 3mb2cACP_c + coa_c
MCACPR	3-Methylcrotonyl-[acp] reductase	3mb2cACP_c + h_c + nadh_c <=> 3mbACP_c + nad_c
BC13FAS	Branched chain C13 fatty acid synthesis	3mbACP_c + 11.0 h_c + 4.0 malACP_c + 8.0 nadph_c <=> 5.0 ACP_c + branch_c13_fa_c + 4.0 co2_c + 3.0 h2o_c + 8.0 nadp_c
BC17FAS	Branched chain C17 fatty acid synthesis	3mbACP_c + 17.0 h_c + 6.0 malACP_c + 12.0 nadph_c <=> 7.0 ACP_c + branch_c17_fa_c + 6.0 co2_c + 5.0 h2o_c + 12.0 nadp_c
MAGS	Monoacyl Glyceride synthesis	0.022 branch_c13_fa_c + 0.133 branch_c17_fa_c + 0.051 deceACP_c + glyc3p_c + 0.552 hexdACP_c + 0.062 ocdACP_c + 0.054 tdeceACP_c + 0.125 tpalm2eACP_c <=> 1ag3p_gen_c + 0.844 ACP_c + 8.881784197001252e-16 h2o_c
DAGS	Diacyl Glyceride synthesis	1ag3p_gen_c + 0.022 branch_c13_fa_c + 0.133 branch_c17_fa_c + 0.051 deceACP_c + 0.552 hexdACP_c + 0.062 ocdACP_c + 0.054 tdeceACP_c + 0.125 tpalm2eACP_c <=> 0.844 ACP_c + 1.3322676295501878e-15 h2o_c + pa_gen_c
DAGK	DAG Kinase	atp_c + dag_gen_c --> adp_c + pa_gen_c
DAGP	DAGP Phosphatase	h2o_c + pa_gen_c --> dag_gen_c + h_c + pi_c
CDGS	CDP-Diacylglycerol Synthase	ctp_c + pa_gen_c --> cdpdag_BS_c + h_c + ppi_c
GDAGS	Glucosyl DAG synthesis	dag_gen_c + 2.0 udpg_c <=> dg12dg_c + 2.0 h_c + 2.0 udp_c
GDAGS2	Glucosyl DAG synthesis	dag_gen_c + 3.0 udpg_c <=> 3.0 h_c + tg12dg_c + 3.0 udp_c
PGLP	Phosphatidylglycerophosphatase	h2o_c + pgp_EC_c --> h_c + pg_SC_c + pi_c
PGLS	Phosphatidylglycerol Synthesis	atp_c + lys__L_c + pg_SC_c --> amp_c + cpd12556_c + 3.0 h_c + ppi_c
CDGSOT	CDP-diacylglycerol-serine O-phosphatidyltransferase	cdpdag_BS_c + ser__L_c <=> cmp_c + 2.0 h_c + ps_BS_c
PHSD	Phosphatidylserine decarboxylase	h_c + ps_BS_c --> co2_c + psetha_BS_c
G3PCT	Glycerol-3-phosphate cytidylyltransferase	ctp_c + glyc3p_c --> cdpglyc_c + ppi_c
GLAS	Glucosyl-lipoteichoic acid synthesis	24.0 cdpglyc_c + dg12dg_c + 24.0 udpg_c --> 24.0 cmp_c + glu_lta_c + 48.0 h_c + 24.0 udp_c
GALAS	Glucosamino-lipoteichoic acid synthesis	24.0 cdpglyc_c + dg12dg_c + 24.0 uacgam_c --> aglu_lta_c + 24.0 cmp_c + 48.0 h_c + 24.0 udp_c
ALLAS	Alanyl-lipoteichoic acid synthesis	24.0 ala__D_c + 24.0 atp_c + 24.0 cdpglyc_c + dg12dg_c + 24.0 h2o_c --> ala_lta_c + 24.0 amp_c + 24.0 cmp_c + 48.0 h_c + 24.0 ppi_c
LAS	Lipoteichoic acid synthesis	24.0 cdpglyc_c + dg12dg_c --> 24.0 cmp_c + 24.0 h_c + lta_c
PDGS	Peptidoglycan synthesis	uaagmda_c --> cpd11452_c + udcpdp_c
GLYTAS	Glycerol Teichoic Acid Synthesis	45.0 cdpglyc_c + uacgam_c + uacmam_c --> cmp_c + gly_tea_c + h_c + udp_c + ump_c
ATAS	Alanyl Teichoic Acid Synthesis	45.0 ala__D_c + 45.0 atp_c + 45.0 cdpglyc_c + 45.0 h2o_c + uacgam_c + uacmam_c --> agly_tea_c + 45.0 amp_c + 45.0 cmp_c + 134.0 h_c + 45.0 ppi_c + udp_c + ump_c
GLUTAS	Glucosyl Teichoic Acid Synthesis	45.0 cdpglyc_c + 45.0 h2o_c + uacgam_c + uacmam_c + 45.0 udpg_c --> 45.0 cmp_c + glygly_tea_c + 90.0 h_c + udp_c + ump_c
MTAS	Minor Teichoic Acid Synthesis	30.0 h2o_c + 30.0 udpacgal_c + 30.0 udpg_c --> 30.0 h_c + min_tea_c + 30.0 udp_c + 30.0 ump_c
ATPM	ATP maintenance requirement	atp_c + h2o_c --> adp_c + h_c + pi_c
CEPA5	cellodextrin phosphorylase, cellohexaose cleaving	cell6_c + pi_c --> cell5_c + g1p_c
CEPA4	cellodextrin phosphorylase, cellopentaose cleaving	cell5_c + pi_c --> cell4_c + g1p_c
CEPA3	cellodextrin phosphorylase, cellotetraose cleaving	cell4_c + pi_c --> cell3_c + g1p_c
CEPA2	cellodextrin phosphorylase, cellotriose cleaving	cell3_c + pi_c --> cellb_c + g1p_c
NH3tabc	Ammonia uptake via abc system	atp_c + h2o_c + nh4_e --> adp_c + h_c + nh4_c + pi_c
H20t	H2O transport via diffusion	h2o_e <=> h2o_c
CO2t	CO2 transporter via diffusion	co2_e <=> co2_c
CEL2abc	Oligo-cellulose (2) transport via ABC system	atp_c + cellb_e + h2o_c --> adp_c + cellb_c + h_c + pi_c
CEL3abc	Oligo-cellulose (3) transport via ABC system	atp_c + cell3_e + h2o_c --> adp_c + cell3_c + h_c + pi_c
CEL4abc	Oligo-cellulose (4) transport via ABC system	atp_c + cell4_e + h2o_c --> adp_c + cell4_c + h_c + pi_c
CEL5abc	Oligo-cellulose (5) transport via ABC system	atp_c + cell5_e + h2o_c --> adp_c + cell5_c + h_c + pi_c
CEL6abc	Oligo-cellulose (6) transport via ABC system	atp_c + cell6_e + h2o_c --> adp_c + cell6_c + h_c + pi_c
UREAabc	Urea transport via ABC system	atp_c + h2o_c + urea_e --> adp_c + h_c + pi_c + urea_c
CA2abc	Calcium transport via ABC system	atp_c + ca2_e + h2o_c --> adp_c + ca2_c + h_c + pi_c
MG2abc	Magnesium transport via ABC system	atp_c + h2o_c + mg2_e --> adp_c + h_c + mg2_c + pi_c
Kabc	Potassium ABC transporter	atp_c + h2o_c + k_e --> adp_c + h_c + k_c + pi_c
SULabc	Sulfate transport via ABC system	atp_c + h2o_c + so4_e --> adp_c + h_c + pi_c + so4_c
PIabc	Phosphate transport via ABC system	atp_c + h2o_c + pi_e --> adp_c + h_c + 2.0 pi_c
FE3abc	Iron (III) transport via ABC system	atp_c + fe3_e + h2o_c --> adp_c + fe3_c + h_c + pi_c
H2St1	H2s transport (diffusion)	h2s_c <=> h2s_e
ALAt2r	L alanine reversible transport via proton symport	ala__L_e + h_e <=> ala__L_c + h_c
ARGt2r	L arginine reversible transport via proton symport	arg__L_e + h_e <=> arg__L_c + h_c
ASNt2r	L asparagine reversible transport via proton symport	asn__L_e + h_e <=> asn__L_c + h_c
ASPt2r	L aspartate reversible transport via proton symport	asp__L_e + h_e <=> asp__L_c + h_c
CYSt2r	L cysteine reversible transport via proton symport	cys__L_e + h_e <=> cys__L_c + h_c
GLUt2r	L glutamate reversible transport via proton symport	glu__L_e + h_e <=> glu__L_c + h_c
GLNt2r	L glutamine reversible transport via proton symport	gln__L_e + h_e <=> gln__L_c + h_c
GLYt2r	L glycine reversible transport via proton symport	gly_e + h_e <=> gly_c + h_c
HISt2r	L histidine reversible transport via proton symport	h_e + his__L_e <=> h_c + his__L_c
ILEt2r	L isoleucine reversible transport via proton symport	h_e + ile__L_e <=> h_c + ile__L_c
LEUt2r	L leucinereversible transport via proton symport	h_e + leu__L_e <=> h_c + leu__L_c
LYSt2r	L lysine reversible transport via proton symport	h_e + lys__L_e <=> h_c + lys__L_c
METt2r	L methionine reversible transport via proton symport	h_e + met__L_e <=> h_c + met__L_c
PHEt2r	L phenylalanine reversible transport via proton symport	h_e + phe__L_e <=> h_c + phe__L_c
PROt2r	L proline reversible transport via proton symport	h_e + pro__L_e <=> h_c + pro__L_c
SERt2r	L serine reversible transport via proton symport	h_e + ser__L_e <=> h_c + ser__L_c
THRt2r	L threonine reversible transport via proton symport	h_e + thr__L_e <=> h_c + thr__L_c
TRYt2r	L tryptophan reversible transport via proton symport	h_e + trp__L_e <=> h_c + trp__L_c
TYRt2r	L tyrosine reversible transport via proton symport	h_e + tyr__L_e <=> h_c + tyr__L_c
VALt2r	L valine reversible transport via proton symport	h_e + val__L_e <=> h_c + val__L_c
ACt2r	Acetate reversible transport via proton symport	ac_e + h_e <=> ac_c + h_c
FORt2	Formate transport in via proton symport	for_e + h_e <=> for_c + h_c
D_LACt2	D lactate transport via proton symport	h_e + lac__L_e <=> h_c + lac__L_c
H2td	Hydrogen transport	h2_c <=> h2_e
PYRt2	Pyruvate transport in via proton symport	h_e + pyr_e <=> h_c + pyr_c
SUCCt2r	Succinate transport via proton symport	h_e + succ_e <=> h_c + succ_c
MAL_Dt2	D malate transport in via proton symport	h_e + mal__L_e <=> h_c + mal__L_c
BTDt_M	meso-Butanediol transport via passive diffusion	btd_M_c <=> btd_M_e
BTDt_RR	(R,R)-Butanediol transport via passive diffusion	btd_RR_c <=> btd_RR_e
PYRGt	Pyroglutamate transport via passive diffusion	5oxpro_c <=> 5oxpro_e
IBUTOHt	Isobutyl alcohol transport extracellular	ibutoh_c <=> ibutoh_e
FUMt2r	Fumarate reversible transport via symport	fum_e + h_e <=> fum_c + h_c
XYLTt	Xylitol transport via passive diffusion	xylt_e <=> xylt_c
PPAna	Inorganic diphosphatase (sodium translocating)	h_c + na1_e + 2.0 pi_c --> h2o_c + na1_c + ppi_c
RBFSb	Riboflavin synthase	2.0 dmlz_c --> 4r5au_c + ribflv_c
PPAKr	Propionate kinase reverse direction	atp_c + ppa_c <=> cpd03560_c + ppi_c
MMCD	Methylmalonyl-CoA decarboxylase (Sodium)	h_e + mmcoa__S_c --> co2_c + ppcoa_c
ICOR	Isocitrate:NADP+ oxidoreductase (decarboxylating) 	icit_c + nadp_c --> h_c + nadph_c + oxasucc_c
PGI	Glucose-6-phosphate isomerase	g6p_c <=> f6p_B_c
DHAD2	Dihydroxy acid dehydratase  2 3 dihydroxy 3 methylpentanoate  	23dhmp_c --> 3mop_c + h2o_c
FBA3	Sedoheptulose 1,7-bisphosphate D-glyceraldehyde-3-phosphate-lyase	s17bp_c <=> dhap_c + e4p_c
PFK3_ppi	Phosphofructokinase (s7p)	ppi_c + s7p_c --> h_c + pi_c + s17bp_c
IBUTCOARx	Isobutyryl-CoA reductase (NADH)	h_c + ibcoa_c + nadh_c --> 2mppal_c + coa_c + nad_c
ALCD23xi	Aldehyde dehydrogenase isobutyl alcohol NAD	2mppal_c + h_c + nadh_c --> ibutoh_c + nad_c
IBUTCOARy	Isobutyryl-CoA reductase (NADPH)	h_c + ibcoa_c + nadph_c --> 2mppal_c + coa_c + nadp_c
ALCD23yi	Aldehyde dehydrogenase isobutyl alcohol NADP	2mppal_c + h_c + nadph_c --> ibutoh_c + nadp_c
NA1abc	Sodium transport via ABC system	atp_c + h2o_c + na1_e --> adp_c + h_c + na1_c + pi_c
Kt3	Potassium transport via proton antiport	h_e + k_c --> h_c + k_e
PIt	inorganic phosphate transporter	h_e + pi_e --> h_c + pi_c
PIt2	inorganic phosphate transporter	pi_e --> pi_c
PNTOt2r	Pantothenate proton symporter	h_e + pnto__R_e <=> h_c + pnto__R_c
PNTOt2r2	Pantothenate sodium symporter	pnto__R_e <=> pnto__R_c
ETOHt	Ethanol transport via diffusion	etoh_c <=> etoh_e
DPR	2-dehydropantoate 2-reductase	2dhp_c + h_c + nadph_c --> nadp_c + pant__R_c
PROCOARx	Propanoyl-CoA reductase (NADH)	h_c + nadh_c + ppcoa_c --> coa_c + nad_c + ppal_c
ALCD3x	Aldehyde dehydrogenase propanal NAD 	h_c + nadh_c + ppal_c --> nad_c + ppoh_c
PROCOARx2	Propanoyl-CoA reductase (NADPH)	h_c + nadph_c + ppcoa_c --> coa_c + nadp_c + ppal_c
ALCD23xi2	Aldehyde dehydrogenase propanal NADP	h_c + nadph_c + ppal_c --> nadp_c + ppoh_c
EX_ppoh_e	propanol exchange	ppoh_c --> 
3MOPDC	Isobutyryl-coA reductase (NADH)	3mop_c + h_c --> 2mbald_c + co2_c
ALCD22xi	Aldehyde dehydrogenase 2 methylbutanol NAD	2mbald_c + h_c + nadh_c --> 2mbtoh_c + nad_c
ALCD22xi2	Aldehyde dehydrogenase 2 methylbutanol NADP	2mbald_c + h_c + nadph_c --> 2mbtoh_c + nadp_c
EX_2mbtoh_e	2 methylbutanol exchange	2mbtoh_c --> 
4MOPDC	4 Methyl 2 oxopentanoate decarboxylase	4mop_c + h_c --> 3mbald_c + co2_c
ALCD3MBOH	Aldehyde dehydrogenase isobutyl alcohol NAD	3mbald_c + h_c + nadh_c --> iamoh_c + nad_c
EX_3mboh_e	Butanol exchange	iamoh_c --> 
ADCL	4-aminobenzoate synthase	4adcho_c --> 4abz_c + h_c + pyr_c
GTPCI	GTP cyclohydrolase I	gtp_c + h2o_c --> ahdt_c + for_c + h_c
AKP1	Alkaline phosphatase Dihydroneopterin	ahdt_c + 3.0 h2o_c --> dhnpt_c + 3.0 h_c + 3.0 pi_c
GCALDD	Glycolaldehyde dehydrogenase	gcald_c + h2o_c + nad_c --> glyclt_c + 2.0 h_c + nadh_c
DM_thf_c	Demand for tetrahydrofolate	thf_c --> 
ASPO2	L-aspartate oxidase	asp__L_c + nad_c --> h_c + iasp_c + nadh_c
ASPO2y	L-aspartate oxidase (nadp)	asp__L_c + nadp_c --> h_c + iasp_c + nadph_c
FUCabc	Fucose transport via ABC system	atp_c + fuc__L_e + h2o_c --> adp_c + fuc__L_c + h_c + pi_c
GLCabc	D-Glucose transport via ABC system	atp_c + glc__D_e + h2o_c --> adp_c + glc__D_c + h_c + pi_c
SBTabc	Sorbitol transport via ABC system	atp_c + h2o_c + sbt__D_e --> adp_c + h_c + pi_c + sbt__D_c
FRUabc	Fructose transport via ABC system	atp_c + fru_e + h2o_c --> adp_c + fru_c + h_c + pi_c
CITt2	Citrate reversible transport via proton symport	cit_c + h_c <=> cit_e + h_e
HSERTA	Homoserine O trans acetylase	accoa_c + hom__L_c <=> achms_c + coa_c
EX_g1p_e	Glucose-1-phosphate exchange	g1p_c --> 
FRDx_c0	succinate_NAD_plus__oxidoreductase_c0	fum_c + h_c + nadh_c --> nad_c + succ_c
BIOMASS_CELLULOSE	C. therm biomass objective function for cellulose grown cultures (20% DCW corresponds to cellulase)	0.00748743523382814 3g12dgr_SA2_c + 0.000534152433717642 aglu_lta_c + 0.237768553303984 ala__L_c + 0.00158916992717985 ala_lta_c + 0.0116337602821264 amp_c + 0.137318628575553 arg__L_c + 0.215131020358229 asn__L_c + 0.221707090346292 asp__L_c + 34.8420958318522 atp_c + 0.0043097597481671 ca2_c + 0.000647759481187439 cdp_c + 0.00039862121919227 clpn_SC_c + 0.00255649075241976 cmp_c + 0.0889984986873116 cpd11452_c + 0.00190009447814982 cpd12556_c + 0.0239915076119174 ctp_c + 0.0373851193849238 cys__L_c + 0.0151825731029196 datp_c + 0.00836405224831501 dctp_c + 0.00965327719143948 dg12dg_c + 0.00836405224831501 dgtp_c + 0.0151825731029196 dttp_c + 0.00463363948876082 fe3_c + 0.000492297205702454 gdp_c + 0.0891679826390155 gln__L_c + 0.242950192068813 glu__L_c + 0.000597931828788405 glu_lta_c + 0.258277615031426 gly_c + 0.00315541913425615 gly_tea_c + 0.00364539104951332 glygly_tea_c + 0.00131711094508113 gmp_c + 0.0235934808278765 gtp_c + 34.7993526138794 h2o_c + 0.0506300524365263 his__L_c + 0.269338479694671 ile__L_c + 0.949831319247849 k_c + 0.283386818078508 leu__L_c + 0.00128356032579911 lta_c + 0.255028939511943 lys__L_c + 0.0808474203153821 met__L_c + 0.136837031202576 mg2_c + 0.00272424384882984 min_tea_c + 0.0403554156779775 nad_c + 0.0233193413227478 nadp_c + 0.000522525981491201 nadph_c + 0.0154465722437005 pg_SC_c + 0.143001341206261 phe__L_c + 0.158841595612381 pro__L_c + 0.0491499963264069 psetha_BS_c + 0.219245254650044 ser__L_c + 0.00579993873924753 tg12dg_c + 0.208262977810495 thr__L_c + 0.049506220332593 trp__L_c + 0.149456513574556 tyr__L_c + 0.0353912265365562 utp_c + 0.244798360888147 val__L_c --> 34.7929397950156 adp_c + 11.801286094508 h_c + 34.7800105157711 pi_c + 0.161679857368271 ppi_c
BIOMASS_CELLOBIOSE	C. therm biomass objective function for cellobiose grown cultures  (2% DCW corresponds to cellulase)	0.00749443085801535 3g12dgr_SA2_c + 0.000534651500429844 aglu_lta_c + 0.226981629081658 ala__L_c + 0.00159065471272163 ala_lta_c + 0.0116446298806306 amp_c + 0.152834432829489 arg__L_c + 0.19337686956005 asn__L_c + 0.203565776332897 asp__L_c + 58.55453625355648 atp_c + 0.00431378642200049 ca2_c + 0.000648364692685445 cdp_c + 0.000398993657037197 clpn_SC_c + 0.00255887932046522 cmp_c + 0.089081651333124 cpd11452_c + 0.00190186976521064 cpd12556_c + 0.0240139232409941 ctp_c + 0.0410739907802319 cys__L_c + 0.0151967584110132 datp_c + 0.00837186690906119 dctp_c + 0.00966229639458412 dg12dg_c + 0.00837186690906119 dgtp_c + 0.0151967584110132 dttp_c + 0.00463796876834322 fe3_c + 0.000492757166440938 gdp_c + 0.0907475198501415 gln__L_c + 0.267038054788532 glu__L_c + 0.000598490485555795 glu_lta_c + 0.238689992949084 gly_c + 0.00315836729016361 gly_tea_c + 0.00364879699360517 glygly_tea_c + 0.00131834154179374 gmp_c + 0.0236155245744981 gtp_c + 58.55453625355648 h2o_c + 0.0505986081135555 his__L_c + 0.297230937300123 ile__L_c + 0.950718761041091 k_c + 0.30404751643422 leu__L_c + 0.00128475957565977 lta_c + 0.283396269735403 lys__L_c + 0.088041844113358 met__L_c + 0.136964880114158 mg2_c + 0.00272678915113504 min_tea_c + 0.0403931203543032 nad_c + 0.023341128936676 nadp_c + 0.000523014185432926 nadph_c + 0.0154610042101914 pg_SC_c + 0.149324601126697 phe__L_c + 0.123899561568787 pro__L_c + 0.0491959179126864 psetha_BS_c + 0.214473177933542 ser__L_c + 0.00580535770989122 tg12dg_c + 0.181493989716975 thr__L_c + 0.0331727351396739 trp__L_c + 0.149596153059727 tyr__L_c + 0.0354242930957506 utp_c + 0.251074983559902 val__L_c --> 58.55453625355648 adp_c + 58.55453625355648 h_c + 58.55453625355648 pi_c + 0.161830917308754 ppi_c
BIOMASS_NO_CELLULOSOME	C. therm biomass objective function for cellobiose grown cultures  (2% DCW corresponds to cellulase)	0.00749520895660359 3g12dgr_SA2_c + 0.000534707009858854 aglu_lta_c + 0.225781837571386 ala__L_c + 0.00159081986017709 ala_lta_c + 0.0116458388677095 amp_c + 0.154560200975742 arg__L_c + 0.190957232145074 asn__L_c + 0.201547982002478 asp__L_c + 32.5645667266435 atp_c + 0.00431423429471939 ca2_c + 0.000648432008224357 cdp_c + 0.00039903508198422 clpn_SC_c + 0.0025591449924588 cmp_c + 0.0890909001084418 cpd11452_c + 0.00190206722412478 cpd12556_c + 0.0240164164523034 ctp_c + 0.0414842909261641 cys__L_c + 0.0151983361927674 datp_c + 0.00837273610619521 dctp_c + 0.00966329956871786 dg12dg_c + 0.00837273610619521 dgtp_c + 0.0151983361927674 dttp_c + 0.00463845029883157 fe3_c + 0.000492808326250511 gdp_c + 0.0909232061993741 gln__L_c + 0.269717262744023 glu__L_c + 0.00059855262297633 glu_lta_c + 0.236511330876703 gly_c + 0.00315869520314009 gly_tea_c + 0.0036491758247457 glygly_tea_c + 0.00131847841672286 gmp_c + 0.0236179764226344 gtp_c + 32.5217791311346 h2o_c + 0.05059511067249 his__L_c + 0.300333316916956 ile__L_c + 0.950817468059649 k_c + 0.306345532993212 leu__L_c + 0.00128489296398919 lta_c + 0.286551467757539 lys__L_c + 0.0888420544806702 met__L_c + 0.136979100297368 mg2_c + 0.00272707225612716 min_tea_c + 0.0403973141123774 nad_c + 0.0233435522960769 nadp_c + 0.000523068486634315 nadph_c + 0.0154626094268885 pg_SC_c + 0.150027915010564 phe__L_c + 0.120013082445257 pro__L_c + 0.0492010256086543 psetha_BS_c + 0.213942396682759 ser__L_c + 0.0058059604428704 tg12dg_c + 0.178516569648822 thr__L_c + 0.0313560192284718 trp__L_c + 0.149611684666824 tyr__L_c + 0.0354279709724259 utp_c + 0.251773110147199 val__L_c --> 32.5153596542532 adp_c + 11.8135386113749 h_c + 32.502416951369 pi_c + 0.161847719172788 ppi_c
EX_h_e	H+ exchange	h_e <=> 
EX_cpd02701_c0	EX_S_Adenosyl_4_methylthio_2_oxobutanoate_c0	amob_c --> 
EX_nh4_e	Ammonia exchange	nh4_e <=> 
EX_h2o_e	H2O exchange	h2o_e <=> 
EX_co2_e	CO2 exchange	co2_e --> 
EX_cellb_e	Cellobiose exchange	cellb_e <-- 
EX_cell3_e	Cellulose (n=3 repeating units) exchange	cell3_e --> 
EX_cell4_e	Cellulose (n=4 repeating units) exchange	cell4_e --> 
EX_cell5_e	Cellulose (n=5 repeating units) exchange	cell5_e --> 
EX_cell6_e	Cellulose (n=6 repeating units) exchange	cell6_e --> 
EX_urea_e	Urea exchange	urea_e --> 
EX_ca2_e	Calcium exchange	ca2_e <=> 
EX_mg2_e	Mg exchange	mg2_e <=> 
EX_k_e	K exchange	k_e <=> 
EX_so4_e	Sulfate exchange	so4_e <=> 
EX_pi_e	Phosphate exchange	pi_e <=> 
EX_fe3_e	Fe3+ exchange	fe3_e <=> 
EX_h2s_e	Hydrogen sulfide exchange	h2s_e --> 
EX_ala__L_e	L-Alanine exchange	ala__L_e --> 
EX_arg__L_e	L-Arginine  exchange	arg__L_e --> 
EX_asn__L_e	L-Asparagine  exchange	asn__L_e --> 
EX_asp__L_e	L-Aspartate  exchange 	asp__L_e --> 
EX_cys__L_e	L-Cysteine  exchange	cys__L_e --> 
EX_glu__L_e	L-Glutamate  exchange 	glu__L_e --> 
EX_gln__L_e	L-Glutamine  exchange	gln__L_e --> 
EX_gly_e	Glycine  exchange	gly_e --> 
EX_his__L_e	L-Histidine  exchange	his__L_e --> 
EX_ile__L_e	L-Isoleucine  exchange 	ile__L_e --> 
EX_leu__L_e	L-Leucine  exchange	leu__L_e --> 
EX_lys__L_e	L-Lysine  exchange	lys__L_e --> 
EX_met__L_e	L-Methionine  exchange	met__L_e --> 
EX_phe__L_e	L-Phenylalanine  exchange 	phe__L_e --> 
EX_pro__L_e	L-Proline  exchange	pro__L_e --> 
EX_ser__L_e	L-Serine  exchange	ser__L_e --> 
EX_thr__L_e	L-Threonine  exchange	thr__L_e --> 
EX_trp__L_e	L-Tryptophan  exchange 	trp__L_e --> 
EX_tyr__L_e	L-Tyrosine  exchange	tyr__L_e --> 
EX_val__L_e	L-Valine  exchange	val__L_e --> 
EX_ac_e	Acetate exchange	ac_e --> 
EX_for_e	Formate exchange	for_e --> 
EX_lac__L_e	L-Lacatate exchange	lac__L_e --> 
EX_h2_e	H2 exchange	h2_e --> 
EX_pyr_e	Pyruvate exchange	pyr_e --> 
EX_succ_e	Succinate exchange	succ_e --> 
EX_mal__L_e	L-Malate exchange	mal__L_e --> 
EX_btd_M_e	meso 2 3 Butanediol exchange	btd_M_e --> 
EX_btd_RR_e	R R 2 3 Butanediol exchange	btd_RR_e --> 
EX_5oxpro_e	Pyroglutamate exchange	5oxpro_e --> 
EX_ibutoh_e	Isobutyl alcohol exchange	ibutoh_e --> 
EX_fum_e	Fumarate exchange	fum_e --> 
EX_xylt_e	Xylitol exchange	xylt_e --> 
EX_pnto__R_e	(R)-Pantothenate exchange	pnto__R_e --> 
EX_etoh_e	Ethanol exchange	etoh_e --> 
EX_na1_e	Sodium exchange	na1_e <=> 
EX_glceq_e	Glucose equivalent exchange	glceq_e --> 
GLCEQ3	Glucose equivalent conversion 3	3.0 glceq_e --> cell3_e + 2.0 h2o_e
GLCEQ4	Glucose equivalent conversion 4	4.0 glceq_e --> cell4_e + 3.0 h2o_e
GLCEQ5	Glucose equivalent conversion 5	5.0 glceq_e --> cell5_e + 4.0 h2o_e
GLCEQ6	Glucose equivalent conversion 6	6.0 glceq_e --> cell6_e + 5.0 h2o_e
EX_fuc__L_e	Fucose exchange	fuc__L_e --> 
EX_glc__D_e	D-Glucose exchange	glc__D_e --> 
EX_sbt__D_e	Sorbitol_c0 exchange	sbt__D_e --> 
EX_fru_e	Fructose exchange	fru_e --> 
EX_cit_e	Citrate exchange	cit_e --> 
